三方五湖=みかたごこ
三河湾=みかわわん
三浦縦貫道路=みうらじゅうかんどうろ
三瀬=みつせ
三陸自動車道=さんりくじどうしゃどう
上高地乗鞍林道=かみこうちのりくらりんどう
下総利根大橋有料道路=しもうさとねおおはしゆうりょうどうろ
中津川道路=なかつがわどうろ
久住高原=くじゅうこうげん
乗鞍=のりくら
九十九里有料道路=くじゅうくりゆうりょうどうろ
二丈浜玉道路=にじょうはまたまどうろ
五輪大橋有料道路=ごりんおおはしゆうりょうどうろ
京都縦貫自動車道=きょうとじゅうかんじどうしゃどう
仁多峠循環自動車道路=にたとうげじゅんかんじどうしゃどうろ
仁淀川河口大橋=によどがわかこうおおはし
仙台南部道路=せんだいなんぶどうろ
仙台松島道路=せんだいまつしまどうろ
伊勢二見鳥羽=いせふたみとば
伊勢志摩=いせしま
伊吹山=いぶきやま
伊豆=いず
伊豆中央道=いずちゅうおうどう
信貴生駒=しぎいこま
修善寺道路=しゅぜんじどうろ
六甲北有料道路=ろっこうきたゆうりょうどうろ
六甲有料道路=ろっこうゆうりょうどうろ
冷川=ひえかわ
冷水道路=ひやみずどうろ
勝浦有料道路=かつうらゆうりょうどうろ
北神=ほくしん
千葉外房有料道路=ちばそとぼうゆうりょうどうろ
南富士=みなみふじ
南知多道路=みなみちたどうろ
厳木多久道路=きゅうらぎたくどうろ
国見道路=くにみどうろ
在来線=ざいらいせん
堺泉北有料道路=さかいせんぼくゆうりょうどうろ
大分湯=おおいたゆ
大分空港道路=おおいたくうこうどうろ
大島大橋=おおしまおおはし
大橋=おおはし
大野川大橋有料道路=おおのがわおおはしゆうりょうどうろ
天草下島横断有料道路=あまくさしもしまおうだんゆうりょうどうろ
奥比叡=おくひえい
妙義荒船林道=みょうぎあらふねりんどう
安芸灘大橋有料道路=あきなだおおはしゆうりょうどうろ
富士=ふじ
富士見=ふじみ
富士見川越有料道路=ふじみかわごえゆうりょうどうろ
小坂井=こざかい
尾張=おわり
尾道大橋有料道路=おのみちおおはしゆうりょうどうろ
屋島=やしま
山口宇部有料道路=やまぐちうべゆうりょうどうろ
山麓=さんろく
岡南大橋=こうなんおおはし
岡山=おかやま
島大橋=しまおおはし
嵐山=あらしやま
川北大橋有料道路=かわきたおおはしゆうりょうどうろ
川平道路=かわびらどうろ
常陸那珂有料道路=ひたちなかゆうりょうどうろ
平戸大橋=ひらどおおはし
平有料道路=ひらゆうりょうどうろ
広島熊野道路=ひろしまくまのどうろ
弁天大橋=べんてんおおはし
彦島有料道路=ひこしまゆうりょうどうろ
志賀中野有料道路=しがなかのゆうりょうどうろ
摩耶大橋=まやおおはし
新大利根橋有料道路=しんおおとねばしゆうりょうどうろ
新掛塚橋=しんかけつかばし
新浦和橋有料道路=しんうらわばしゆうりょうどうろ
新見沼大橋有料道路=しんみぬまおおはしゆうりょうどうろ
日和大橋=ひよりおおはし
日塩道路=にちえんどうろ
日本平=にほんだいら
日立有料道路=ひたちゆうりょうどうろ
日野水口道路=ひのみなくちどうろ
有峰林道=ありみねりんどう
有料道路=ゆうりょうどうろ
本坂=ほんざか
本宮山=ほんぐうさん
本町山中有料道路=ほんちょうやまなかゆうりょうどうろ
村櫛舘山寺道路=むらくしかんざんじどうろ
東予道路=とうよどうろ
東総有料道路=とうそうゆうりょうどうろ
東金九十九里有料道路=とうがねくじゅうくりゆうりょうどうろ
松戸三郷有料道路=まつどみさとゆうりょうどうろ
松戸橋有料道路=まつどばしゆうりょうどうろ
松戸野田有料道路=まつどのだゆうりょうどうろ
松浦=まつうら
林道=りんどう
母成=ぼなり
比叡山=ひえいざん
水海道有料道路=みつかいどうゆうりょうどうろ
水玉=みずたま
水郷有料道路=すいごうゆうりょうどうろ
永平寺有料道路=えいへいじゆうりょうどうろ
河口湖大橋=かわぐちこおおはし
河野海岸有料道路=こうのかいがんゆうりょうどうろ
法恩寺山有料道路=ほうおんじさんゆうりょうどうろ
津峯=つのみね
津軽岩木=つがるいわき
流山有料道路=ながれやまゆうりょうどうろ
浜名湖=はまなこ
浦戸大橋=うらどおおはし
海田大橋=かいたおおはし
淀川河辺有料道路=よどがわかわべゆうりょうどうろ
清水日本平=しみずにほんだいら
清里高原道路=きよさとこうげんどうろ
湯殿山自動車道=ゆどのさんじどうしゃどう
湯河原=ゆがわら
熊谷東松山有料道路=くまがやひがしまつやまゆうりょうどうろ
熱海=あたみ
牧山道路=まきやまどうろ
狭山環状有料道路=さやまかんじょうゆうりょうどうろ
猿投=さなげ
琵琶湖大橋=びわこおおはし
生月大橋=いきつきおおはし
田鶴浜道路=たつるはまどうろ
白糸=しらいと
白馬長野有料道路=はくばながのゆうりょうどうろ
矢上大橋=やがみおおはし
知多半島横断道路=ちたはんとうおうだんどうろ
知多半島道路=ちたはんとうどうろ
石岡有料道路=いしおかゆうりょうどうろ
磐梯吾妻=ばんだいあづま
磐梯山=ばんだいさん
福岡前原道路=ふくおかまえばるどうろ
稲城大橋有料道路=いなぎおおはしゆうりょうどうろ
立山有料道路=たてやまゆうりょうどうろ
第二=だいに
第二阪奈有料道路=だいにはんなゆうりょうどうろ
筑波=つくば
箱根=はこね
米良有料道路=めらゆうりょうどうろ
綾部宮津道路=あやべみやづどうろ
羽黒山自動車道=はぐろさんじどうしゃどう
能登半島縦貫有料道路=のとはんとうじゅうかんゆうりょうどうろ
能登海浜道路=のとかいひんどうろ
能越自動車道=のうえつじどうしゃどう
船原=ふなばら
芦有=ろゆう
茅野有料道路=ちのゆうりょうどうろ
茶臼山高原道路=ちゃうすやまこうげんどうろ
草津沼田道路=くさつぬまたどうろ
菅原城北大橋有料道路=すがはらしろきたおおはしゆうりょうどうろ
萩有料道路=はぎゆうりょうどうろ
蔵王=ざおう
藻岩山観光自動車道=もいわやまかんこうじどうしゃどう
衣浦=きぬうら
表六甲=おもてろっこう
表筑波=おもてつくば
裏六甲=うらろっこう
西伊豆=にしいず
西吾妻=にしあづま
西宮北道路=にしのみやきたどうろ
西海=さいかい
西海道路=にしうみどうろ
西神戸有料道路=にしこうべゆうりょうどうろ
西蔵王高原=にしざおうこうげん
近江大橋=おうみおおはし
途中=とちゅう
逗葉新道=ずようしんどう
遠阪=とおさか
那智山=なちざん
那須甲子有料道路=なすかしゆうりょうどうろ
銚子有料道路=ちょうしゆうりょうどうろ
阿蘇山公園道路=あそさんこうえんどうろ
阿蘇登山有料道路=あそとざんゆうりょうどうろ
雁坂=かりさか
霧降高原有料道路=きりふりこうげんゆうりょうどうろ
青森中央大橋有料道路=あおもりちゅうおうおおはしゆうりょうどうろ
青森空港有料道路=あおもりくうこうゆうりょうどうろ
音羽蒲郡有料道路=おとわがまごおりゆうりょうどうろ
飛騨美濃道路=ひだみのどうろ
高松坂出有料道路=たかまつさかいでゆうりょうどうろ
高知桂浜道路=こうちかつらはまどうろ
高野龍神=こうやりゅうじん
高雄=たかお
鬼怒川道路=きぬがわどうろ
鳥栖筑紫野道路=とすちくしのどうろ
鳥飼仁和寺大橋有料道路=とりかいにわじおおはしゆうりょうどうろ
鳳来寺山=ほうらいじさん
鴨川有料道路=かもがわゆうりょうどうろ
鹿曲川林道=かくまがわりんどう
