御殿場=ごてんば
御殿場市駒門=ごてんばしこまかど
長泉沼津=ながいずみぬまづ
駿東郡長泉町元長窪=すんとうぐんながいずみちょうもとながくぼ
駿河湾沼津=するがわんぬまづ
沼津市根古屋=ぬまづしねごや
新富士=しんふじ
富士市厚原=ふじしあつはら
新清水=しんしみず
静岡市清水区宍原=しずおかししみずくししはら
清水=しみず
静岡市清水区小河内=しずおかししみずくこごうち
静岡市清水区吉原=しずおかししみずくよしわら
静岡市清水区杉山=しずおかししみずくすぎやま
新静岡=しんしずおか
静岡市葵区下=しずおかしあおいくしも
静岡=しずおか
静岡市葵区小瀬戸=しずおかしあおいくこぜと
静岡市葵区飯間=しずおかしあおいくはんま
藤枝岡部=ふじえだおかべ
藤枝市岡部町入野=ふじえだしおかべちょういりの
藤枝=ふじえだ
藤枝市花倉=ふじえだしはなぐら
島田金谷=しまだかなや
島田市横岡新田=しまだしよこおかしんでん
掛川=かけがわ
掛川市倉真=かけがわしくらみ
森掛川=もりかけがわ
周智郡森町睦実=しゅうちぐんもりまちむつみ
遠州森町=えんしゅうもりまち
周智郡森町円田=しゅうちぐんもりまちえんでん
浜松浜北=はままつはまきた
浜松市浜北区中瀬=はままつしはまきたくなかぜ
浜松=はままつ
浜松市浜北区四大地=はままつしはまきたくよんだいち
浜松市北区引佐町東黒田=はままつしきたくいなさちょうひがしくろだ
新東名高速道路=しんとうめいこうそくどうろ
