江差線=えさしせん
札沼線=さっしょうせん
石勝線=せきしょうせん
石北線=せきほくせん
釧網線=せんもうせん
宗谷線=そうやせん
千歳線=ちとせせん
津軽海峡線=つがるかいきょうせん
根室線=ねむろせん
函館線=はこだてせん
日高線=ひだかせん
富良野線=ふらのせん
室蘭線=むろらんせん
留萌線=るもいせん
吾妻線=あがつません
赤羽線=あかばねせん
秋田新幹線=あきたしんかんせん
左沢線=あてらざわせん
飯山線=いいやません
石巻線=いしのまきせん
五日市線=いつかいちせん
伊東線=いとうせん
岩泉線=いわいずみせん
羽越線=うえつせん
内房線=うちぼうせん
越後線=えちごせん
奥羽線=おううせん
青梅線=おうめせん
大糸線=おおいとせん
大船渡線=おおふなとせん
大湊線=おおみなとせん
男鹿線=おがせん
鹿島線=かしません
釜石線=かまいしせん
烏山線=からすやません
川越線=かわごえせん
北上線=きたかみせん
久留里線=くるりせん
京浜東北線=けいひんとうほくせん
京葉線=けいようせん
気仙沼線=けせんぬません
小海線=こうみせん
五能線=ごのうせん
埼京線=さいきょうせん
相模線=さがみせん
井線=しののいせん
上越新幹線=じょうえつしんかんせん
上越線=じょうえつせん
常磐線=じょうばんせん
信越線=しんえつせん
水郡線=すいぐんせん
仙山線=せんざんせん
仙石線=せんせきせん
総武線=そうぶせん
外房線=そとぼうせん
高崎線=たかさきせん
田沢湖線=たざわこせん
只見線=ただみせん
中央線=ちゅうおうせん
津軽線=つがるせん
鶴見線=つるみせん
東海道線=とうかいどうせん
東金線=とうがねせん
東北新幹線=とうほくしんかんせん
東北線=とうほくせん
長野新幹線=ながのしんかんせん
成田線=なりたせん
南武線=なんぶせん
日光線=にっこうせん
根岸線=ねぎしせん
白新線=はくしんせん
八高線=はちこうせん
八戸線=はちのへせん
花輪線=はなわせん
磐越西線=ばんえつさいせん
磐越東線=ばんえつとうせん
北陸新幹線=ほくりくしんかんせん
水戸線=みとせん
武蔵野線=むさしのせん
弥彦線=やひこせん
山形新幹線=やまがたしんかんせん
山田線=やまだせん
山手線=やまのてせん
横須賀線=よこすかせん
横浜線=よこはません
米坂線=よねさかせん
陸羽西線=りくうさいせん
陸羽東線=りくうとうせん
両毛線=りょうもうせん
飯田線=いいだせん
関西線=かんさいせん
紀勢線=きせいせん
御殿場線=ごてんばせん
参宮線=さんぐうせん
太多線=たいたせん
高山線=たかやません
武豊線=たけとよせん
東海道新幹線=とうかいどうしんかんせん
身延線=みのぶせん
名松線=めいしょうせん
赤穂線=あこうせん
因美線=いんびせん
宇野線=うのせん
宇部線=うべせん
越美北線=えつみほくせん
九頭竜線=くずりゅうせん
大阪環状線=おおさかかんじょうせん
東線=おおさかひがしせん
小野田線=おのだせん
小浜線=おばません
加古川線=かこがわせん
片町線=かたまちせん
可部線=かべせん
関西空港線=かんさいくうこうせん
岩徳線=がんとくせん
姫新線=きしんせん
木次線=きすきせん
吉備線=きびせん
草津線=くさつせん
呉線=くれせん
芸備線=げいびせん
湖西線=こせいせん
境線=さかいせん
桜井線=さくらいせん
桜島線=さくらじません
山陰線=さんいんせん
三江線=さんこうせん
山陽新幹線=さんようしんかんせん
山陽線=さんようせん
城端線=じょうはなせん
新湊線=しんみなとせん
瀬戸大橋線=せとおおはしせん
津山線=つやません
富山港線=とやまこうせん
七尾線=ななおせん
奈良線=ならせん
博多南線=はかたみなみせん
伯備線=はくびせん
播但線=ばんたんせん
阪和線=はんわせん
氷見線=ひみせん
福塩線=ふくえんせん
福知山線=ふくちやません
北陸線=ほくりくせん
本四備讃線=ほんしびさんせん
舞鶴線=まいづるせん
美祢線=みねせん
山口線=やまぐちせん
和歌山線=わかやません
内子線=うちこせん
高徳線=こうとくせん
徳島線=とくしません
土讃線=どさんせん
鳴門線=なるとせん
牟岐線=むぎせん
予讃線=よさんせん
予土線=よどせん
指宿枕崎線=いぶすきまくらざきせん
大村線=おおむらせん
鹿児島本=かごしません
香椎線=かしいせん
唐津線=からつせん
吉都線=きっとせん
九州新幹線=きゅうしゅうしんかんせん
久大線=きゅうだいせん
後藤寺線=ごとうじせん
篠栗線=ささぐりせん
佐世保線=させぼせん
筑肥線=ちくひせん
筑豊線=ちくほうせん
長崎線=ながさきせん
日南線=にちなんせん
日豊線=にっぽうせん
肥薩線=ひさつせん
日田彦山線=ひたひこさんせん
豊肥線=ほうひせん
三角線=みすみせん
宮崎空港線=みやざきくうこうせん
