一条線=いちじょうせん
一畑電気鉄道=いちばたでんきてつどう
七尾線=ななおせん
万葉線=まんようせん
三国芦原線=みくにあわらせん
三岐線=さんぎせん
三岐鉄道=さんぎてつどう
三木線=みきせん
三木鉄道=みきてつどう
三河島線=みかわしません
三河線=みかわせん
三田線=さんだせん
三田線=みたせん
三陸鉄道=さんりくてつどう
上信線=じょうしんせん
上信電鉄=じょうしんでんてつ
上毛線=じょうもうせん
上毛電気鉄道=じょうもうでんきてつどう
上滝線=かみだきせん
上熊本線=かみくまもとせん
上田交通=うえだこうつう
上町線=うえまちせん
上野懸垂線=うえのけんすいせん
上高地線=かみこうちせん
下北交通=しもきたこうつう
不二越線=ふじこしせん
世田谷線=せたがやせん
中央線=ちゅうおうせん
中村線=なかむらせん
丹後海陸交通=たんごかいりくこうつう
久里浜線=くりはません
亀戸線=かめいどせん
井原線=いばらせん
井原鉄道=いばらてつどう
井川線=いかわせん
交野線=かたのせん
京成本線=けいせいほんせん
京成電鉄=けいせいでんてつ
京津線=けいしんせん
京浜急行電鉄=けいひんきゅうこうでんてつ
京王線=けいおうせん
京王電鉄=けいおうでんてつ
京福電気鉄道=けいふくでんきてつどう
京葉臨海鉄道=けいようりんかいてつどう
京都市交通局=きょうとしこうつうきょく
京都本線=きょうとほんせん
京都線=きょうとせん
京阪本線=けいはんほんせん
京阪電気鉄道=けいはんでんきてつどう
今津線=いまづせん
仙台埠頭線=せんだいふとうせん
仙台市交通局=せんだいしこうつうきょく
仙台臨海鉄道=せんだいりんかいてつどう
仙台西港線=せんだいにしこうせん
伊丹線=いたみせん
伊予鉄道=いよてつどう
伊勢崎線=いせさきせん
伊勢線=いせせん
伊勢鉄道=いせてつどう
伊奈線=いなせん
伊田線=いたせん
伊豆急行=いずきゅうこう
伊豆急行線=いずきゅうこうせん
伊豆箱根鉄道=いずはこねてつどう
伊賀線=いがせん
伊野線=いのせん
会津線=あいづせん
会津鉄道=あいづてつどう
会津鬼怒川線=あいづきぬがわせん
佐野線=さのせん
信楽線=しがらきせん
信楽高原鐵道=しがらきこうげんてつどう
信貴線=しぎせん
健軍線=けんぐんせん
八戸臨海鉄道=はちのへりんかいてつどう
八戸臨海鉄道線=はちのへりんかいてつどうせん
八日市線=ようかいちせん
八王子線=はちおうじせん
八百津線=やおつせん
公園都市線=こうえんとしせん
六甲摩耶鉄道=ろっこうまやてつどう
内部線=うつべせん
函館市交通局=はこだてしこうつうきょく
別府国際観光=べっぷこくさいかんこう
別所線=べっしょせん
加太線=かだせん
加越能鉄道=かえつのうてつどう
動物園線=どうぶつえんせん
北九州線=きたきゅうしゅうせん
北九州高速鉄道=きたきゅうしゅうこうそくてつどう
北勢線=ほくせいせん
北大阪急行電鉄=きたおおさかきゅうこうでんてつ
北条線=ほうじょうせん
北条鉄道=ほうじょうてつどう
北松江線=きたまつえせん
北神急行電鉄=ほくしんきゅうこうでんてつ
北神線=ほくしんせん
北総開発鉄道=ほくそうかいはつてつどう
北越急行=ほくえつきゅうこう
北野線=きたのせん
北陸鉄道=ほくりくてつどう
十和田観光電鉄=とわだかんこうでんてつ
十和田観光電鉄線=とわだかんこうでんてつせん
十国鋼索線=じっこくこうさくせん
千代田線=ちよだせん
千原線=ちはらせん
千日前線=せんにちまえせん
千葉急行電鉄=ちばきゅうこうでんてつ
千葉線=ちばせん
千里線=せんりせん
千鳥線=ちどりせん
半田線=はんだせん
半蔵門線=はんぞうもんせん
南北線=なんぼくせん
南大阪線=みなみおおさかせん
南海本線=なんかいほんせん
南海電気鉄道=なんかいでんきてつどう
南港線=なんこうせん
南部縦貫=なんぶじゅうかん
南部縦貫鉄道=なんぶじゅうかんてつどう
南阿蘇鉄道=みなみあそてつどう
厚木線=あつぎせん
叡山本線=えいざんほんせん
叡山電鉄=えいざんでんてつ
各務原線=かかみがはらせん
吉野線=よしのせん
名古屋市交通局=なごやしこうつうきょく
名古屋本線=なごやほんせん
名古屋線=なごやせん
名古屋臨海鉄道=なごやりんかいてつどう
名古屋鉄道=なごやてつどう
名城線=めいじょうせん
呉羽線=くれはせん
和歌山港線=わかやまこうせん
唐湊線=とそせん
国分寺線=こくぶんじせん
国際文化公園都市線=こくさいぶんかこうえんとしせん
土佐電気鉄道=とさでんきてつどう
城北線=じょうほくせん
城南線=じょうなんせん
埼玉新都市交通=さいたましんとしこうつう
埼玉高速鉄道=さいたまこうそくてつどう
埼玉高速鉄道線=さいたまこうそくてつどうせん
堺筋線=さかいすじせん
多奈川線=たながわせん
多摩川線=たまがわせん
多摩湖線=たまこせん
多摩線=たません
多賀線=たがせん
大井川本線=おおいがわほんせん
大井川鐵道=おおいがわてつどう
大井町線=おおいまちせん
大山観光電鉄=おおやまかんこうでんてつ
大山鋼索線=おおやまこうさくせん
大師線=だいしせん
大手町線=おおてまちせん
大月線=おおつきせん
大森線=おおもりせん
大江戸線=おおえどせん
大洗鹿島線=おおあらいかしません
大浦支線=おおうらしせん
大畑線=おおはたせん
大社線=たいしゃせん
大阪市交通局=おおさかしこうつうきょく
大阪府都市開発=おおさかふとしかいはつ
大阪線=おおさかせん
大阪高速鉄道=おおさかこうそくてつどう
大雄山線=だいゆうざんせん
大鰐線=おおわにせん
天理線=てんりせん
天神大牟田線=てんじんおおむたせん
天竜浜名湖線=てんりゅうはまなこせん
天竜浜名湖鉄道=てんりゅうはまなこてつどう
太宰府線=だざいふせん
太平洋石炭販売輸送=たいへいようせきたんはんばいゆそう
太郎代線=たろうだいせん
奈良線=ならせん
妙見線=みょうけんせん
宇品線=うじなせん
宇治線=うじせん
宇都宮線=うつのみやせん
安比奈線=あひなせん
安野屋線=やすのやせん
宝塚本線=たからづかほんせん
宝来線=ほうらいせん
宮地岳線=みやじだけせん
宮島線=みやじません
宮津線=みやづせん
宮福線=みやふくせん
宿毛線=すくもせん
富士急行=ふじきゅうこう
富山地方鉄道=とやまちほうてつどう
富山市内軌道支線=とやましないきどうしせん
富山市内軌道本線=とやましないきどうほんせん
小倉線=こくらせん
小名浜埠頭本線=おなはまふとうほんせん
小坂線=こさかせん
小坂製錬=こさかせいれん
小泉線=こいずみせん
小湊鉄道=こみなとてつどう
小湊鉄道線=こみなとてつどうせん
小牧線=こまきせん
小田原線=おだわらせん
小田急電鉄=おだきゅうでんてつ
尾西線=びさいせん
屋島登山鉄道=やしまとざんてつどう
山万=やままん
山口線=やまぐちせん
山形鉄道=やまがたてつどう
山田線=やまだせん
山陽電気鉄道=さんようでんきてつどう
山鼻線=やまはなせん
山鼻西線=やまはなにしせん
岐阜市内線=ぎふしないせん
岡山電気軌道=おかやまでんききどう
岩手開発鉄道=いわてかいはつてつどう
岳南鉄道=がくなんてつどう
岳南鉄道線=がくなんてつどうせん
島原鉄道=しまばらてつどう
島原鉄道線=しまばらてつどうせん
嵐山本線=あらしやまほんせん
嵐山線=あらしやません
嵯峨野観光線=さがのかんこうせん
嵯峨野観光鉄道=さがのかんこうてつどう
川鉄道=がわてつどう
市橋線=いちはしせん
帝都高速度交通営団=ていとこうそくどこうつうえいだん
常滑線=とこなめせん
常総線=じょうそうせん
平成筑豊鉄道=へいせいちくほうてつどう
幹線=かんせん
広島短距離交通瀬野線=ひろしまたんきょりこうつうせのせん
広島電鉄=ひろしまでんてつ
広島高速交通=ひろしまこうそくこうつう
広見線=ひろみせん
弘南線=こうなんせん
弘南鉄道=こうなんてつどう
彩都線=さいとせん
後免線=ごめんせん
御堂筋線=みどうすじせん
御岳登山鉄道=みたけとざんてつどう
御所線=ごせせん
志度線=しどせん
志摩線=しません
愛知環状鉄道=あいちかんじょうてつどう
愛知環状鉄道線=あいちかんじょうてつどうせん
押上線=おしあげせん
拝島線=はいじません
揖斐線=いびせん
新京成線=しんけいせいせん
新京成電鉄=しんけいせいでんてつ
新宿線=しんじゅくせん
新湊港線=しんみなとこうせん
新潟交通=にいがたこうつう
新潟交通線=にいがたこうつうせん
新潟臨海鉄道=にいがたりんかいてつどう
新玉川線=しんたまがわせん
日光線=にっこうせん
日比谷線=ひびやせん
日生線=にっせいせん
日立電鉄=ひたちでんてつ
日立電鉄線=ひたちでんてつせん
日頃市線=ひころいちせん
早稲田線=わせだせん
明知線=あけちせん
明知鉄道=あけちてつどう
昭和町線=しょうわまちせん
昼飯線=ひるいせん
智頭急行=ちづきゅうこう
智頭線=ちづせん
有楽町線=ゆうらくちょうせん
有田鉄道=ありだてつどう
有馬線=ありません
本牧線=ほんもくせん
本町線=ほんまちせん
本線=ほんせん
札幌市交通局=さっぽろしこうつうきょく
東上本線=とうじょうほんせん
東京急行電鉄=とうきょうきゅうこうでんてつ
東京臨海新交通臨海線=とうきょうりんかいしんこうつうりんかいせん
東京臨海高速鉄道=とうきょうりんかいこうそくてつどう
東京都交通局=とうきょうとこうつうきょく
東大阪線=ひがしおおさかせん
東山本線=ひがしやまほんせん
東山線=ひがしやません
東急多摩川線=とうきゅうたまがわせん
東成田線=ひがしなりたせん
東横線=とうよこせん
東武鉄道=とうぶてつどう
東海交通事業=とうかいこうつうじぎょう
東港線=とうこうせん
東田本線=あずまだほんせん
東築線=とうちくせん
東葉高速線=とうようこうそくせん
東葉高速鉄道=とうようこうそくてつどう
東西線=とうざいせん
東豊線=とうほうせん
松本電気鉄道=まつもとでんきてつどう
松浦鉄道=まつうらてつどう
桃花台新交通=とうかだいしんこうつう
桃花台線=とうかだいせん
桐生線=きりゅうせん
桜町線=さくらまちせん
桜通線=さくらどおりせん
桟橋線=さんばしせん
横川線=よこがわせん
横河原線=よこがわらせん
横浜市交通局=よこはましこうつうきょく
横浜新都市交通=よこはましんとしこうつう
樽見線=たるみせん
樽見鉄道=たるみてつどう
橿原線=かしはらせん
武庫川線=むこがわせん
比叡山鉄道=ひえいざんてつどう
比叡山鉄道線=ひえいざんてつどうせん
比治山線=ひじやません
水前寺線=すいぜんじせん
水島本線=みずしまほんせん
水島臨海鉄道=みずしまりんかいてつどう
水江線=みずえせん
水間線=みずません
水間鉄道=みずまてつどう
永平寺線=えいへいじせん
汐見町線=しおみちょうせん
江波線=えばせん
池上線=いけがみせん
池袋線=いけぶくろせん
河口湖線=かわぐちこせん
河和線=こうわせん
河東線=かとうせん
泉北高速鉄道線=せんぼくこうそくてつどうせん
津島線=つしません
津軽鉄道=つがるてつどう
津軽鉄道線=つがるてつどうせん
浅草線=あさくさせん
浅野川線=あさのがわせん
浮島線=うきしません
海岸線=かいがんせん
海浜鉄道=かいひんてつどう
清輝橋線=せいきばしせん
渓谷線=けいこくせん
渓谷鐵道=けいこくてつどう
渥美線=あつみせん
港東線=こうとうせん
湊線=みなとせん
湯前線=ゆのまえせん
滝野川線=たきのがわせん
瀬戸線=せとせん
烏丸線=からすません
無軌条電車線=むきじょうでんしゃせん
熊本市交通局=くまもとしこうつうきょく
熊本電気鉄道=くまもとでんきてつどう
犬山線=いぬやません
狭山線=さやません
琴平線=ことひらせん
甘木線=あまぎせん
甘木鉄道=あまぎてつどう
生駒線=いこません
生駒鋼索線=いこまこうさくせん
田原本線=たわらもとせん
田園都市線=でんえんとしせん
田園鉄道=でんえんてつどう
田園鉄道線=でんえんてつどうせん
田崎線=たさきせん
田川線=たがわせん
田神線=たがみせん
由利高原鉄道=ゆりこうげんてつどう
甲陽線=こうようせん
白島線=はくしません
皆実線=みなみせん
目蒲線=めかません
目黒線=めぐろせん
相模原線=さがみはらせん
相模鉄道=さがみてつどう
真岡線=もおかせん
真岡鐵道=もおかてつどう
知多新線=ちたしんせん
石山坂本線=いしやまさかもとせん
石川線=いしかわせん
碧南線=へきなんせん
神奈川臨海鉄道=かながわりんかいてつどう
神岡線=かみおかせん
神岡鉄道=かみおかてつどう
神戸市交通局=こうべしこうつうきょく
神戸市都市整備公社=こうべしとしせいびこうしゃ
神戸新交通=こうべしんこうつう
神戸本線=こうべほんせん
神戸電鉄=こうべでんてつ
神戸高速線=こうべこうそくせん
神戸高速鉄道=こうべこうそくてつどう
福井鉄道=ふくいてつどう
福岡市交通局=ふくおかしこうつうきょく
福島交通=ふくしまこうつう
福島臨海鉄道=ふくしまりんかいてつどう
福島臨海鉄道本線=ふくしまりんかいてつどうほんせん
福武線=ふくぶせん
秋田内陸線=あきたないりくせん
秋田内陸縦貫鉄道=あきたないりくじゅうかんてつどう
秋田臨海鉄道=あきたりんかいてつどう
秋田臨海鉄道線=あきたりんかいてつどうせん
秩父本線=ちちぶほんせん
秩父鉄道=ちちぶてつどう
空港線=くうこうせん
立山線=たてやません
立山開発鉄道=たてやまかいはつてつどう
立山黒部貫光=たてやまくろべかんこう
競馬場線=けいばじょうせん
竹鼻線=たけはなせん
第一期線=だいいっきせん
第二期線=だいにきせん
筑波観光鉄道=つくばかんこうてつどう
筑豊電気鉄道=ちくほうでんきてつどう
箕面線=みのおせん
箱崎線=はこざきせん
箱根登山鉄道=はこねとざんてつどう
築港線=ちっこうせん
粟生線=あおせん
糸田線=いとだせん
紀州鉄道=きしゅうてつどう
紀州鉄道線=きしゅうてつどうせん
網干線=あぼしせん
総武流山線=そうぶながれやません
総武流山電鉄=そうぶながれやまでんてつ
線=せん
美濃町線=みのまちせん
羽島線=はしません
能勢電鉄=のせでんてつ
能登線=のとせん
臨海副都心線=りんかいふくとしんせん
臨海本線=りんかいほんせん
臨港線=りんこうせん
花園線=はなぞのせん
若桜線=わかさせん
若桜鉄道=わかさてつどう
苫小牧港開発=とまこまいこうかいはつ
苫小牧港開発株式会社線=とまこまいこうかいはつかぶしきがいしゃせん
茨城交通=いばらきこうつう
荒川線=あらかわせん
菊池線=きくちせん
蒲原鉄道=かんばらてつどう
蒲原鉄道線=かんばらてつどうせん
蒲郡線=がまごおりせん
藤崎線=ふじさきせん
蛍茶屋支線=ほたるぢゃやしせん
衣浦臨海鉄道=きぬうらりんかいてつどう
西九州線=にしきゅうしゅうせん
西信貴鋼索線=にししぎこうさくせん
西埠頭線=にしふとうせん
西大阪線=にしおおさかせん
西尾線=にしおせん
西日本鉄道=にしにっぽんてつどう
西武園線=せいぶえんせん
西武有楽町線=せいぶゆうらくちょうせん
西武秩父線=せいぶちちぶせん
西武鉄道=せいぶてつどう
西濃鉄道=せいのうてつどう
谷地頭線=やちがしらせん
谷山線=たにやません
谷汲線=たにぐみせん
谷町線=たにまちせん
豊島線=としません
豊川線=とよかわせん
豊橋鉄道=とよはしてつどう
豊田線=とよたせん
貴志川線=きしがわせん
赤崎線=あかさきせん
赤迫線=あかさこせん
越前本線=えちぜんほんせん
越生線=おごせせん
越美南線=えつみなんせん
近江鉄道=おうみてつどう
近畿日本鉄道=きんきにっぽんてつどう
近鉄連絡線=きんてつれんらくせん
逗子線=ずしせん
道明寺線=どうみょうじせん
遠州鉄道=えんしゅうてつどう
郡中線=ぐんちゅうせん
野岩鉄道=やがんてつどう
野田線=のだせん
金町線=かなまちせん
鈴鹿線=すずかせん
鉄道=てつどう
鉄道線=てつどうせん
銀座線=ぎんざせん
銀河線=ぎんがせん
銚子電気鉄道=ちょうしでんきてつどう
銚子電気鉄道線=ちょうしでんきてつどうせん
鋼索線=こうさくせん
錦川清流線=にしきがわせいりゅうせん
錦川鉄道=にしきがわてつどう
長堀鶴見緑地線=ながほりつるみりょくちせん
長尾線=ながおせん
長崎電気軌道=ながさきでんききどう
長良川鉄道=ながらがわてつどう
長野線=ながのせん
長野電鉄=ながのでんてつ
関東鉄道=かんとうてつどう
関西電力=かんさいでんりょく
関西電力線=かんさいでんりょくせん
阪堺線=はんかいせん
阪堺電気軌道=はんかいでんききどう
阪急電鉄=はんきゅうでんてつ
阪神電気鉄道=はんしんでんきてつどう
阿佐東線=あさとうせん
阿佐海岸鉄道=あさかいがんてつどう
阿武隈急行=あぶくまきゅうこう
阿武隈急行線=あぶくまきゅうこうせん
難波線=なんばせん
静岡清水線=しずおかしみずせん
静岡鉄道=しずおかてつどう
鞍馬寺=くらまでら
鞍馬山鋼索鉄道=くらまやまこうさくてつどう
鞍馬線=くらません
飯坂線=いいざかせん
養老線=ようろうせん
駿豆線=すんずせん
高千穂線=たかちほせん
高千穂鉄道=たかちほてつどう
高尾登山電鉄=たかおとざんでんてつ
高尾線=たかおせん
高岡軌道線=たかおかきどうせん
高師浜支線=たかしのはましせん
高松琴平電気鉄道=たかまつことひらでんきてつどう
高森線=たかもりせん
高浜線=たかはません
高野線=こうやせん
鬼怒川線=きぬがわせん
鳥羽線=とばせん
鴨東線=おうとうせん
鶴舞線=つるまいせん
鹿児島市交通局=かごしましこうつうきょく
鹿島臨海鉄道=かしまりんかいてつどう
鹿島臨港線=かしまりんこうせん
鹿島鉄道=かしまてつどう
鹿島鉄道線=かしまてつどうせん
黒石線=くろいしせん
黒部峡谷鉄道=くろべきょうこくてつどう
