神武天皇=じんむてんのう
畝傍山東北陵=うねびやまのうしとらのすみのみささぎ
綏靖天皇=すいぜいてんのう
桃花鳥田丘上陵=つきだのおかのえのみささぎ
安寧天皇=あんねいてんのう
畝傍山西南御陰井上陵=うねびやまのひつじさるのみほどのいのえのみささぎ
畝傍山南纖沙溪上陵=うねびやまのみなみのまなごのたにのえのみささぎ
孝昭天皇=こうしょうてんのう
掖上博多山上陵=わきのかみのはかたのやまのえのみささぎ
孝安天皇=こうあんてんのう
玉手丘上陵=たまてのおかのえのみささぎ
孝霊天皇=こうれいてんのう
片丘馬坂陵=かたおかのうまさかのみささぎ
孝元天皇=こうげんてんのう
剣池嶋上陵=つるぎのいけのしまのえのみささぎ
開化天皇=かいかてんのう
春日率川坂上陵=かすがのいざかわのさかのえのみささぎ
崇神天皇=すじんてんのう
山邊道勾岡上陵=やまのべのみちのまがりのおかのえのみささぎ
垂仁天皇=すいにんてんのう
菅原伏見東陵=すがわらのふしみのひがしのみささぎ
景行天皇=けいこうてんのう
山邊道上陵=やまのべのみちのえのみささぎ
成務天皇=せいむてんのう
狹城盾列池後陵=さきのたたなみのいけじりのみささぎ
仲哀天皇=ちゅうあいてんのう
惠我長野西陵=えがのながののにしのみささぎ
応神天皇=おうじんてんのう
惠我藻伏崗陵=えがのもふしのおかのみささぎ
仁徳天皇=にんとくてんのう
百舌鳥耳原中陵=もずのみみはらのなかのみささぎ
履中天皇=りちゅうてんのう
百舌鳥耳原南陵=もずのみみはらのみなみのみささぎ
反正天皇=はんぜいてんのう
百舌鳥耳原北陵=もずのみみはらのきたのみささぎ
允恭天皇=いんぎょうてんのう
惠我長野北陵=えがのながののきたのみささぎ
安康天皇=あんこうてんのう
菅原伏見西陵=すがわらのふしみのにしのみささぎ
雄略天皇=ゆうりゃくてんのう
丹比高鷲原陵=たじひのたかわしのはらのみささぎ
清寧天皇=せいねいてんのう
河内坂門原陵=こうちのさかどのはらのみささぎ
顕宗天皇=けんぞうてんのう
傍丘磐坏丘南陵=かたおかのいわつきのおかのみなみのみささぎ
仁賢天皇=にんけんてんのう
埴生坂本陵=はにゅうのさかもとのみささぎ
武烈天皇=ぶれつてんのう
傍丘磐坏丘北陵=かたおかのいわつきのおかのきたのみささぎ
継体天皇=けいたいてんのう
三嶋藍野陵=みしまのあいののみささぎ
安閑天皇=あんかんてんのう
古市高屋丘陵=ふるちのたかやのおかのみささぎ
宣化天皇=せんかてんのう
身狹桃花鳥坂上陵=むさのつきさかのえのみささぎ
欽明天皇=きんめいてんのう
檜隈坂合陵=ひのくまのさかあいのみささぎ
敏達天皇=びだつてんのう
河内磯長中尾陵=こうちのしながのなかのおのみささぎ
用明天皇=ようめいてんのう
河内磯長原陵=こうちのしながのはらのみささぎ
崇峻天皇=すしゅんてんのう
倉梯岡陵=くらはしのおかのみささぎ
推古天皇=すいこてんのう
磯長山田陵=しながのやまだのみささぎ
舒明天皇=じょめいてんのう
押坂内陵=おさかのうちのみささぎ
皇極天皇=こうぎょくてんのう
越智崗上陵=おちのおかのえのみささぎ
孝徳天皇=こうとくてんのう
大阪磯長陵=おおさかのしながのみささぎ
斉明天皇=さいめいてんのう
天智天皇=てんじてんのう
山科陵=やましなのみささぎ
弘文天皇=こうぶんてんのう
長等山前陵=ながらのやまさきのみささぎ
天武天皇=てんむてんのう
檜隈大内陵=ひのくまのおおうちのみささぎ
持統天皇=じとうてんのう
文武天皇=もんむてんのう
檜隈安古岡上陵=ひのくまのあこのおかのえのみささぎ
元明天皇=げんめいてんのう
奈保山東陵=なほやまのひがしのみささぎ
元正天皇=げんしょうてんのう
奈保山西陵=なほやまのにしのみささぎ
聖武天皇=しょうむてんのう
佐保山南陵=さほやまのみなみのみささぎ
孝謙天皇=こうけんてんのう
高野陵=たかののみささぎ
淳仁天皇=じゅんにんてんのう
淡路陵=あわじのみささぎ
称徳天皇=しょうとくてんのう
光仁天皇=こうにんてんのう
田原東陵=たはらのひがしのみささぎ
桓武天皇=かんむてんのう
柏原陵=かしわばらのみささぎ
平城天皇=へいぜいてんのう
楊梅陵=やまもものみささぎ
嵯峨天皇=さがてんのう
嵯峨山上陵=さがのやまのえのみささぎ
淳和天皇=じゅんなてんのう
大原野西嶺上陵=おおはらののにしのみねのえのみささぎ
仁明天皇=にんみょうてんのう
深草陵=ふかくさのみささぎ
文徳天皇=もんとくてんのう
田邑陵=たむらのみささぎ
清和天皇=せいわてんのう
水尾山陵=みずのおやまのみささぎ
陽成天皇=ようぜいてんのう
神楽岡東陵=かぐらがおかのひがしのみささぎ
光孝天皇=こうこうてんのう
後田邑陵=のちのたむらのみささぎ
宇多天皇=うだてんのう
大内山陵=おおうちやまのみささぎ
醍醐天皇=だいごてんのう
後山科陵=のちのやましなのみささぎ
朱雀天皇=すざくてんのう
醍醐陵=だいごのみささぎ
村上天皇=むらかみてんのう
村上陵=むらかみのみささぎ
冷泉天皇=れいぜいてんのう
桜本陵=さくらもとのみささぎ
円融天皇=えんゆうてんのう
後村上陵=のちのむらかみのみささぎ
花山天皇=かざんてんのう
紙屋川上陵=かみやがわのほとりのみささぎ
一条天皇=いちじょうてんのう
圓融寺北陵=えんゆうじのきたのみささぎ
三条天皇=さんじょうてんのう
北山陵=きたやまのみささぎ
後一条天皇=ごいちじょうてんのう
菩提樹院陵=ぼだいじゅいんのみささぎ
後朱雀天皇=ごすざくてんのう
圓乘寺陵=えんじょうじのみささぎ
後冷泉天皇=ごれいぜいてんのう
圓教寺陵=えんきょうじのみささぎ
後三条天皇=ごさんじょうてんのう
圓宗寺陵=えんそうじのみささぎ
白河天皇=しらかわてんのう
成菩提院陵=じょうぼだいいんのみささぎ
堀河天皇=ほりかわてんのう
後圓教寺陵=のちのえんきょうじのみささぎ
鳥羽天皇=とばてんのう
安楽壽院陵=あんらくじゅいんのみささぎ
崇徳天皇=すとくてんのう
白峯陵=しらみねのみささぎ
近衞天皇=このえてんのう
安樂壽院南陵=あんらくじゅいんのみなみのみささぎ
後白河天皇=ごしらかわてんのう
法住寺陵=ほうじゅうじのみささぎ
二条天皇=にじょうてんのう
香隆寺陵=こうりゅうじのみささぎ
六条天皇=ろくじょうてんのう
清閑寺陵=せいかんじのみささぎ
高倉天皇=たかくらてんのう
後清閑寺陵=のちのせいかんじのみささぎ
阿彌陀寺陵=あみだじのみささぎ
後鳥羽天皇=ごとばてんのう
大原陵=おおはらのみささぎ
土御門天皇=つちみかどてんのう
金原陵=かねがはらのみささぎ
順徳天皇=じゅんとくてんのう
仲恭天皇=ちゅうきょうてんのう
九條陵=くじょうのみささぎ
後堀河天皇=ごほりかわてんのう
觀音寺陵=かんおんじのみささぎ
四条天皇=しじょうてんのう
月輪陵=つきのわのみささぎ
後嵯峨天皇=ごさがてんのう
嵯峨南陵=さがのみなみのみささぎ
後深草天皇=ごふかくさてんのう
深草北陵=ふかくさのきたのみささぎ
亀山天皇=かめやまてんのう
龜山陵=かめやまのみささぎ
後宇多天皇=ごうだてんのう
蓮華峯寺陵=れんげぶじのみささぎ
伏見天皇=ふしみてんのう
後伏見天皇=ごふしみてんのう
後二条天皇=ごにじょうてんのう
北白河陵=きたしらかわのみささぎ
花園天皇=はなぞのてんのう
十楽院上陵=じゅうらくいんのうえのみささぎ
後醍醐天皇=ごだいごてんのう
塔尾陵=とうのおのみささぎ
山国陵=やまくにのみささぎ
光明天皇=こうみょうてんのう
大光明寺陵=だいこうみょうじのみささぎ
崇光天皇=すこうてんのう
後円融天皇=ごえんゆうてんのう
後村上天皇=ごむらかみてんのう
檜尾陵=ひのおのみささぎ
長慶天皇=ちょうけいてんのう
嵯峨東陵=さがのひがしのみささぎ
後亀山天皇=ごかめやまてんのう
嵯峨小倉陵=さがのおぐらのみささぎ
後小松天皇=ごこまつてんのう
称光天皇=しょうこうてんのう
後花園天皇=ごはなぞのてんのう
後山国陵=のちのやまくにのみささぎ
後土御門天皇=ごつちみかどてんのう
後柏原天皇=ごかしわばらてんのう
後奈良天皇=ごならてんのう
正親町天皇=おおぎまちてんのう
後陽成天皇=ごようぜいてんのう
後水尾天皇=ごみずのおてんのう
明正天皇=めいしょうてんのう
後光明天皇=ごこうみょうてんのう
後西天皇=ごさいてんのう
霊元天皇=れいげんてんのう
東山天皇=ひがしやまてんのう
中御門天皇=なかみかどてんのう
桜町天皇=さくらまちてんのう
桃園天皇=ももぞのてんのう
後桜町天皇=ごさくらまちてんのう
後桃園天皇=ごももぞのてんのう
光格天皇=こうかくてんのう
後月輪陵=のちのつきのわのみささぎ
仁孝天皇=にんこうてんのう
孝明天皇=こうめいてんのう
後月輪東山陵=のちのつきのわのひがしのみささぎ
明治天皇=めいじてんのう
伏見桃山陵=ふしみのももやまのみささぎ
大正天皇=たいしょうてんのう
多摩陵=たまのみささぎ
昭和天皇=しょうわてんのう
武藏野陵=むさしののみささぎ
今上天皇=きんじょうてんのう
