藻岩山観光自動車道=もいわやまかんこうじどうしゃどう
有料道路=ゆうりょうどうろ
第二=だいに
青森中央大橋有料道路=あおもりちゅうおうおおはしゆうりょうどうろ
青森空港有料道路=あおもりくうこうゆうりょうどうろ
津軽岩木=つがるいわき
三陸自動車道=さんりくじどうしゃどう
仙台松島道路=せんだいまつしまどうろ
仙台南部道路=せんだいなんぶどうろ
日和大橋=ひよりおおはし
牧山道路=まきやまどうろ
蔵王=ざおう
淀川河辺有料道路=よどがわかわべゆうりょうどうろ
西蔵王高原=にしざおうこうげん
羽黒山自動車道=はぐろさんじどうしゃどう
湯殿山自動車道=ゆどのさんじどうしゃどう
西吾妻=にしあづま
磐梯山=ばんだいさん
磐梯吾妻=ばんだいあづま
母成=ぼなり
那須甲子有料道路=なすかしゆうりょうどうろ
霧降高原有料道路=きりふりこうげんゆうりょうどうろ
日塩道路=にちえんどうろ
鬼怒川道路=きぬがわどうろ
那須高原道路=なすこうげんどうろ
宇都宮鹿沼道路=うつのみやかぬまどうろ
水郷有料道路=すいごうゆうりょうどうろ
霞=かすみ
浦大橋有料道路=うらおおはしゆうりょうどうろ
新大利根橋有料道路=しんおおとねばしゆうりょうどうろ
石岡有料道路=いしおかゆうりょうどうろ
筑波=つくば
表筑波=おもてつくば
下総利根大橋有料道路=しもうさとねおおはしゆうりょうどうろ
日立有料道路=ひたちゆうりょうどうろ
水海道有料道路=みつかいどうゆうりょうどうろ
常陸那珂有料道路=ひたちなかゆうりょうどうろ
万座=まんざ
万座温泉=まんざおんせん
三原=みはら
峰=みね
茶屋=ちゃや
三才山=みさやま
松本=まつもと
新和田=しんわだ
茅野有料道路=ちのゆうりょうどうろ
平井寺=ひらいじ
志賀中野有料道路=しがなかのゆうりょうどうろ
白馬長野有料道路=はくばながのゆうりょうどうろ
五輪大橋有料道路=ごりんおおはしゆうりょうどうろ
霧=きり
峰有料道路=みねゆうりょうどうろ
白糸=しらいと
妙義荒船林道=みょうぎあらふねりんどう
上高地乗鞍林道=かみこうちのりくらりんどう
蓼科=たてしな
林道夢=りんどうゆめ
平線=だいらせん
鹿曲川林道=かくまがわりんどう
原林道=はらりんどう
林道=りんどう
熊谷東松山有料道路=くまがやひがしまつやまゆうりょうどうろ
富士見川越有料道路=ふじみかわごえゆうりょうどうろ
狭山環状有料道路=さやまかんじょうゆうりょうどうろ
新浦和橋有料道路=しんうらわばしゆうりょうどうろ
新見沼大橋有料道路=しんみぬまおおはしゆうりょうどうろ
銚子新大橋有料道路=ちょうししんおおはしゆうりょうどうろ
利根=とね
大橋有料道路=おおはしゆうりょうどうろ
松戸橋有料道路=まつどばしゆうりょうどうろ
松戸三郷有料道路=まつどみさとゆうりょうどうろ
松戸野田有料道路=まつどのだゆうりょうどうろ
流山有料道路=ながれやまゆうりょうどうろ
銚子有料道路=ちょうしゆうりょうどうろ
鴨川有料道路=かもがわゆうりょうどうろ
勝浦有料道路=かつうらゆうりょうどうろ
房総=ぼうそう
千葉外房有料道路=ちばそとぼうゆうりょうどうろ
九十九里有料道路=くじゅうくりゆうりょうどうろ
東総有料道路=とうそうゆうりょうどうろ
東金九十九里有料道路=とうがねくじゅうくりゆうりょうどうろ
稲城大橋有料道路=いなぎおおはしゆうりょうどうろ
逗葉新道=ずようしんどう
本町山中有料道路=ほんちょうやまなかゆうりょうどうろ
三浦縦貫道路=みうらじゅうかんどうろ
城=じょう
島大橋=しまおおはし
湯河原=ゆがわら
箱根=はこね
大観山線=だいかんざんせん
十国線=じゅっこくせん
芦=あし
湖=こ
富士=ふじ
河口湖大橋=かわぐちこおおはし
岳横断道路=たけおうだんどうろ
雁坂=かりさか
清里高原道路=きよさとこうげんどうろ
立山有料道路=たてやまゆうりょうどうろ
能越自動車道=のうえつじどうしゃどう
有峰林道=ありみねりんどう
能登海浜道路=のとかいひんどうろ
能登半島縦貫有料道路=のとはんとうじゅうかんゆうりょうどうろ
川北大橋有料道路=かわきたおおはしゆうりょうどうろ
田鶴浜道路=たつるはまどうろ
白山=はくさん
岳有料道路=だけゆうりょうどうろ
永平寺有料道路=えいへいじゆうりょうどうろ
河野海岸有料道路=こうのかいがんゆうりょうどうろ
法恩寺山有料道路=ほうおんじさんゆうりょうどうろ
三方五湖=みかたごこ
弁天大橋=べんてんおおはし
村櫛舘山寺道路=むらくしかんざんじどうろ
冷川=ひえかわ
船原=ふなばら
伊豆中央道=いずちゅうおうどう
新掛塚橋=しんかけつかばし
修善寺道路=しゅぜんじどうろ
伊豆=いず
日本平=にほんだいら
西伊豆=にしいず
浜名湖=はまなこ
南富士=みなみふじ
熱海=あたみ
富士見=ふじみ
清水日本平=しみずにほんだいら
本坂=ほんざか
音羽蒲郡有料道路=おとわがまごおりゆうりょうどうろ
小坂井=こざかい
茶臼山高原道路=ちゃうすやまこうげんどうろ
尾張=おわり
小牧東=こまきひがし
知多半島道路=ちたはんとうどうろ
南知多道路=みなみちたどうろ
知多半島横断道路=ちたはんとうおうだんどうろ
衣浦=きぬうら
猿投=さなげ
三=さん
三河湾=みかわわん
鳳来寺山=ほうらいじさん
本宮山=ほんぐうさん
奥志摩=おくしま
伊勢二見鳥羽=いせふたみとば
伊勢志摩=いせしま
飛騨美濃道路=ひだみのどうろ
乗鞍=のりくら
中津川道路=なかつがわどうろ
長良川=ながらがわ
道路=どうろ
伊吹山=いぶきやま
琵琶湖大橋=びわこおおはし
近江大橋=おうみおおはし
日野水口道路=ひのみなくちどうろ
途中=とちゅう
奥比叡=おくひえい
比叡山=ひえいざん
嵐山=あらしやま
高雄=たかお
京都縦貫自動車道=きょうとじゅうかんじどうしゃどう
綾部宮津道路=あやべみやづどうろ
奈良奥山=ならおくやま
新若草山=しんわかくさやま
高円山=たかまどやま
第二阪奈有料道路=だいにはんなゆうりょうどうろ
信貴生駒=しぎいこま
鳥飼仁和寺大橋有料道路=とりかいにわじおおはしゆうりょうどうろ
堺泉北有料道路=さかいせんぼくゆうりょうどうろ
大橋=おおはし
関西国際空港連絡橋=かんさいこくさいくうこうれんらくきょう
菅原城北大橋有料道路=すがはらしろきたおおはしゆうりょうどうろ
高野龍神=こうやりゅうじん
紀=き
川河口大橋=かわかこうおおはし
那智山=なちざん
遠阪=とおさか
西宮北道路=にしのみやきたどうろ
六甲有料道路=ろっこうゆうりょうどうろ
表六甲=おもてろっこう
裏六甲=うらろっこう
六甲=ろっこう
線=せん
六甲北有料道路=ろっこうきたゆうりょうどうろ
北神=ほくしん
新神戸=しんこうべ
西神戸有料道路=にしこうべゆうりょうどうろ
在来線=ざいらいせん
山麓=さんろく
摩耶大橋=まやおおはし
芦有=ろゆう
岡南大橋=こうなんおおはし
岡山=おかやま
水玉=みずたま
広島熊野道路=ひろしまくまのどうろ
安芸灘大橋有料道路=あきなだおおはしゆうりょうどうろ
尾道大橋有料道路=おのみちおおはしゆうりょうどうろ
草津沼田道路=くさつぬまたどうろ
海田大橋=かいたおおはし
山口宇部有料道路=やまぐちうべゆうりょうどうろ
彦島有料道路=ひこしまゆうりょうどうろ
萩有料道路=はぎゆうりょうどうろ
火=ひ
山=やま
津峯=つのみね
高松坂出有料道路=たかまつさかいでゆうりょうどうろ
屋島=やしま
東予道路=とうよどうろ
西海道路=にしうみどうろ
高知桂浜道路=こうちかつらはまどうろ
浦戸大橋=うらどおおはし
仁淀川河口大橋=によどがわかこうおおはし
冷水道路=ひやみずどうろ
福岡前原道路=ふくおかまえばるどうろ
二丈浜玉道路=にじょうはまたまどうろ
鳥栖筑紫野道路=とすちくしのどうろ
三瀬=みつせ
厳木多久道路=きゅうらぎたくどうろ
国見道路=くにみどうろ
平戸大橋=ひらどおおはし
矢上大橋=やがみおおはし
川平道路=かわびらどうろ
松浦=まつうら
生月大橋=いきつきおおはし
西海=さいかい
大島大橋=おおしまおおはし
仁多峠循環自動車道路=にたとうげじゅんかんじどうしゃどうろ
天草下島横断有料道路=あまくさしもしまおうだんゆうりょうどうろ
阿蘇登山有料道路=あそとざんゆうりょうどうろ
阿蘇山公園道路=あそさんこうえんどうろ
臼杵坂=うすきさか
市有料道路=いちゆうりょうどうろ
大野川大橋有料道路=おおのがわおおはしゆうりょうどうろ
大分湯=おおいたゆ
平有料道路=ひらゆうりょうどうろ
米良有料道路=めらゆうりょうどうろ
大分空港道路=おおいたくうこうどうろ
久住高原=くじゅうこうげん
一=ひと
葉道路=ばどうろ
小倉=おぐら
浜道路=はまどうろ
