報告書=ほうこくしょ
青い太陽=あおいたいよう
青空=あおぞら
赤雪=あかゆき
亜寒帯気候=あかんたいきこう
秋雨前線=あきさめぜんせん
秋晴れ=あきばれ
悪天=あくてん
朝曇り=あさぐもり
朝凪=あさなぎ
朝焼け=あさやけ
通風乾湿計=つうふうかんしつけい
風=かぜ
亜熱帯気候=あねったいきこう
亜熱帯高気圧=あねったいこうきあつ
雨脚=あまあし
雨足=あまあし
雨脚=うきゃく
雨脚=あめあし
雨足=あめあし
雨台風=あめたいふう
雨柱=あめばしら
雨名月=あめめいげつ
霰=あられ
安定指数=あんていしすう
安定比=あんていひ
雲=ぐも
医学気象予報=いがくきしょうよほう
十六夜=いざよい
石狩湾低気圧=いしかりわんていきあつ
異常可聴域=いじょうかちょういき
異常乾燥=いじょうかんそう
異常気象=いじょうきしょう
異常屈折=いじょうくっせつ
伊勢湾台風=いせわんたいふう
位相速度=いそうそくど
一次循環=いちじじゅんかん
一次大気=いちじたいき
一次低気圧=いちじていきあつ
一地点予報=いちちてんよほう
１ヶ月予報=いっかげつよほう
逸散速度=いっさんそくど
一発雷=いっぱつかみなり
一般流=いっぱんりゅう
移動性高気圧=いどうせいこうきあつ
移動性低気圧=いどうせいていきあつ
稲妻=いなずま
稲田の御光=いなだのごこう
衣服気候=いふくきこう
居待月=いまちづき
芋名月=いもめいげつ
移流霧=いりゅうぎり
右岸=うがん
雨季=うき
浮島=うきしま
雨月=うげつ
渦=うず
雨水=うすい
雨水=あまみず
渦位=うずい
薄雲=うすぐも
薄曇=うすぐもり
渦性降雨=うずせいこうう
渦雷=うずらい
内暈=うちかさ
宇宙気象学=うちゅうきしょうがく
宇宙空間=うちゅうくうかん
宇宙塵=うちゅうじん
宇宙線=うちゅうせん
卯の花くたし=うのはなくたし
雨氷=うひょう
馬の緯度=うまのいど
海明け=うみあけ
海風=うみかぜ
海風前線=うみかぜぜんせん
海霧=うみぎり
海沿い=うみぞい
海鳴り=うみなり
海開き=うみびらき
裏御光=うらごこう
浦西=うらにし
雨量因子=うりょういんし
雨量計=うりょうけい
雨量ます=うりょうます
雨量予報=うりょうよほう
雲間放電=うんかんほうでん
雲形=うんけい
雲頂=うんちょう
運動学=うんどうがく
雲量=うんりょう
永久凍結気候=えいきゅうとうけつきこう
永久凍土=えいきゅうとうど
永年気候観測=えいねんきこうかんそく
液状化現象=えきじょうかげんしょう
計画=けいかく
伝播=でんぱ
型全天日射計=がたぜんてんにっしゃけい
塩害=えんがい
沿海州=えんかいしゅう
塩化露点湿度計=えんかろてんしつどけい
沿岸霧=えんがんきり
円形渦の不安定度=えんけいうずのふあんていど
煙塵帽=えんじんぼう
塩水害=えんすいがい
鉛直=えんちょく
鉛直視程=えんちょくしてい
鉛直循環=えんちょくじゅんかん
塩風害=えんふうがい
掩ぺい現象=えんぺいげんしょう
煙霧=えんむ
大潮=おおしお
欧州衛星=おうしゅうえいせい
応用気候学=おうようきこうがく
応用気象学=おうようきしょうがく
応力=おうりょく
大雨=おおあめ
大雨警報=おおあめけいほう
大雨情報=おおあめじょうほう
大雨注意報=おおあめちゅういほう
大荒れ=おおあれ
大しけ=おおしけ
大地震=おおじしん
大西風=おおにしかぜ
大雪=おおゆき
大雪警報=おおゆきけいほう
大雪注意報=おおゆきちゅういほう
小笠原気団=おがさわらきだん
小笠原高気圧=おがさわらこうきあつ
送り梅雨=おくりづゆ
おそ霜=おそじも
層=そう
音の異常伝播=おとのいじょうでんぱ
海気団=かいきだん
海高気圧=かいこうきあつ
おぼろ雲=おぼろぐも
御神渡り=おみわたり
氷堤=ひょうてい
親潮=おやしお
颪=おろし
温位=おんい
直達日射計=ちょくたつにっしゃけい
温室効果=おんしつこうか
温帯気候=おんたいきこう
温帯低気圧=おんたいていきあつ
温暖化情報=おんだんかじょうほう
温暖前線=おんだんぜんせん
温度計=おんどけい
温度風=おんどふう
温度目盛=おんどめもり
音波=おんぱ
音波探測=おんぱたんそく
温量指数=おんりょうしすう
怪雨=かいう
海塩核=かいえんかく
開花前線=かいかぜんせん
開花予想=かいかよそう
快感帯=かいかんたい
海気相互作用=かいきそうごさよう
階級別日数=かいきゅうべつにっすう
外気圏=がいきけん
外圏=がいけん
海上一般警報=かいじょういっぱんけいほう
海上気象観測=かいじょうきしょうかんそく
海上警報=かいじょうけいほう
快晴=かいせい
解析=かいせき
回折=かいせつ
外接環=がいせつかん
外聴域=がいちょういき
快適曲線=かいてききょくせん
回転水槽実験=かいてんすいそうじっけん
回転帯=かいてんたい
海難=かいなん
海抜高度=かいばつこうど
海氷=かいひょう
外部重力波=がいぶじゅうりょくは
外部波=がいぶは
海洋気象台=かいようきしょうだい
海洋気団=かいようきだん
海洋性寒帯気団=かいようせいかんたいきだん
海洋性熱帯気団=かいようせいねったいきだん
海洋度=かいようど
海洋度角=かいようどかく
界雷=かいらい
解離=かいり
海陸風=かいりくふう
海嶺=かいれい
科学圏=かがくけん
鉤状雲=かぎじょううん
角運動量=かくうんどうりょう
核化作用=かくかさよう
較差=かくさ
較差=こうさ
核の冬=かくのふゆ
角波数=かくはすう
確率雨量=かくりつうりょう
確率予報=かくりつよほう
崖崩れ=がけくずれ
陽炎=かげろう
下降気流=かこうきりゅう
可降水量=かこうすいりょう
可航半円=かこうはんえん
過去天気=かこてんき
暈=かさ
火災気象=かさいきしょう
火災雲=かさいぐも
火災警報=かさいけいほう
火砕流=かさいりゅう
風下波=かざしもは
風花=かざはな
吹越=ふっこし
風花=かざばな
風向き=かざむき
可視画像=かしがぞう
可視光線=かしこうせん
可照時間=かしょうじかん
過剰虹=かじょうにじ
花信風=かしんふう
霞=かすみ
風台風=かぜたいふう
風津波=かぜつなみ
風雪崩=かぜなだれ
風の伯爵夫人=かぜのはくしゃくふじん
下層=かそう
下層大気=かそうたいき
滑昇霧=かっしょうぎり
滑走路視距離=かっそうろしきょり
予報=よほう
下部摩擦層=かぶまさつそう
花粉症=かふんしょう
花粉分析=かふんぶんせき
花粉予報=かふんよほう
過飽和=かほうわ
湿度計=しつどけい
鎌鼬=かまいたち
雷=かみなり
雷三日=かみなりみっか
空風=からっかぜ
乾風=からっかぜ
空梅雨=からつゆ
仮温度=かりおんど
過冷却=かれいきゃく
川霧=かわぎり
川の氷=かわのこおり
干害=かんがい
寒害=かんがい
乾季=かんき
寒気=かんき
寒気湖=かんきこ
冷気湖=れいきこ
寒気舌=かんきぜつ
寒気団=かんきだん
寒気の吹き出し=かんきのふきだし
乾球温度=かんきゅうおんど
寒極=かんきょく
管区気象台=かんくきしょうだい
寒候期=かんこうき
乾湿計=かんしつけい
慣性重力波=かんせいじゅうりょくは
慣性小領域=かんせいしょうりょういき
慣性波=かんせいは
慣性不安定=かんせいふあんてい
慣性不安定度=かんせいふあんていど
慣性流=かんせいりゅう
乾舌=かんぜつ
間接循環=かんせつじゅんかん
乾燥害=かんそうがい
乾燥空気=かんそうくうき
乾燥断熱減率=かんそうだんねつげんりつ
乾燥断熱変化=かんそうだんねつへんか
乾燥注意報=かんそうちゅういほう
観測原簿=かんそくげんぼ
観測所=かんそくしょ
観測網=かんそくもう
観測野帳=かんそくやちょう
寒帯気候=かんたいきこう
寒帯前線気流=かんたいぜんせんきりゅう
寒帯東風=かんたいとうふう
寒帯偏東風=かんたいへんとうふう
観天望気=かんてんぼうき
寒冬=かんとう
寒の入り=かんのいり
寒の戻り=かんのもどり
寒波=かんぱ
旱魃=かんばつ
乾風害=かんぷうがい
日照計=にっしょうけい
寒冷渦=かんれいうず
寒冷前線=かんれいぜんせん
寒冷低気圧=かんれいていきあつ
寒露=かんろ
放射計=ほうしゃけい
気圧=きあつ
気圧計=きあつけい
気圧傾度=きあつけいど
気圧の尾根=きあつのおね
気圧の谷=きあつのたに
気圧波=きあつは
気圧配置=きあつはいち
気圧配置飛行=きあつはいちひこう
気圧変化=きあつへんか
気圧偏差=きあつへんさ
気温=きおん
気化熱=きかねつ
気球観測=ききゅうかんそく
危険水位=きけんすいい
危険半円=きけんはんえん
季語=きご
気候=きこう
気候資源=きこうしげん
気象資源=きしょうしげん
気膠質=きこうしつ
気候分類=きこうぶんるい
気候変化=きこうへんか
気候変動=きこうへんどう
器差補正=きさほせい
樹雨=きさめ
偽湿球温度=ぎしっきゅうおんど
擬似不安定=ぎじふあんてい
基準観測所=きじゅんかんそくじょ
気象=きしょう
気象運動学=きしょううんどうがく
気象衛星=きしょうえいせい
気象音響学=きしょうおんきょうがく
気象学=きしょうがく
気象官署=きしょうかんしょ
気象観測所=きしょうかんそくしょ
気象観測船=きしょうかんそくせん
気象観測網=きしょうかんそくもう
気象季節=きしょうきせつ
気象記念日=きしょうきねんび
気象業務法=きしょうぎょうむほう
気象警報=きしょうけいほう
気象研究所=きしょうけんきゅうしょ
気象光学=きしょうこうがく
気象災害=きしょうさいがい
気象産業=きしょうさんぎょう
気象事業=きしょうじぎょう
気象情報=きしょうじょうほう
気象証明=きしょうしょうめい
気象常用表=きしょうじょうようひょう
気象信号標識=きしょうしんごうひょうしき
気象制御=きしょうせいぎょ
気象台=きしょうだい
気象大学校=きしょうだいがっこう
気象注意報=きしょうちゅういほう
気象潮=きしょうちょう
気象庁=きしょうちょう
気象通信網=きしょうつうしんもう
気象通報=きしょうつうほう
気象電報=きしょうでんぽう
気象熱力学=きしょうねつりきがく
気象病=きしょうびょう
気象放送=きしょうほうそう
気象無線模写放送=きしょうむせんもしゃほうそう
気象要素=きしょうようそ
気象予報士=きしょうよほうし
気象力学=きしょうりくがく
季節現象=きせつげんしょう
季節内変動=きせつないへんどう
季節病=きせつびょう
季節風=きせつふう
季節風気候=きせつふうきこう
季節風帯=きせつふうたい
季節予報=きせつよほう
気体温度計=きたいおんどけい
気団=きだん
気団性降水=きだんせいこうすい
偽断熱変化=ぎだんねつへんか
気団分析=きだんぶんせき
気柱抵抗=きちゅうていこう
きつねの嫁入り=きつねのよめいり
起動風速=きどうふうそく
きのこ雲=きのこぐも
木花=きばな
基本流=きほんりゅう
逆転=ぎゃくてん
逆転層=ぎゃくてんそう
逆放射=ぎゃくほうしゃ
客観解析=きゃっかんかいせき
客観的予報=きゃっかんてきよほう
客観的天気予報=きゃっかんてきてんきよほう
吸湿性核=きゅうしつせいかく
吸湿性凝結核=きゅうしつせいぎょうけつかく
球電=きゅうでん
境界条件=きょうかいじょうけん
境界層=きょうかいそう
境界値問題=きょうかいちもんだい
凝結=ぎょうけつ
凝結核=ぎょうけつかく
凝結高度=ぎょうけつこうど
峡谷風=きょうこくふう
凝集=ぎょうしゅう
強制波=きょうせいは
強風=きょうふう
凶暴な=きょうぼうな
度=ど
共鳴理論=きょうめいりろん
漁業気象通報=ぎょぎょうきしょうつうほう
漁業無線気象通報=ぎょぎょうむせんきしょうつうほう
極域周回気球計画=きょくいきしゅうかいききゅうけいかく
極渦=きょくうず
曲管地中温度計=きょくかんちちゅうおんどけい
極気団=きょくきだん
極軌道=きょくきどう
局所的熱力学的平衡=きょくしょてきねつりきがくてきへいこう
極成層圏雲=きょくせいそうけんくも
極前線=きょくぜんせん
極値=きょくち
局地気候=きょくちきこう
局地気象=きょくちきしょう
局地風=きょくちふう
局地不連続線=きょくちふれんぞくせん
局地予報=きょくちよほう
極年観測=きょくねんかんそく
極夜渦=きょくやうず
極夜=きょくや
巨大粒子=きょだいりゅうし
極光=きょっこう
霧=きり
霧雨=きりさめ
霧虹=きりにじ
記録的短時間大雨情報=きろくてきたんじかんおおあめじょうほう
均質圏=きんしつけん
銀盤日射計=ぎんばんにっしゃけい
空域予報=くういきよほう
空間電荷=くうかんでんか
空気調節=くうきちょうせつ
空地電流=くうちでんりゅう
空電=くうでん
鯨の尾型=くじらのおがた
颶風=ぐふう
具風=ぐふう
雲=くも
雲粒=くもつぶ
雲物理学=くもぶつりがく
雲放電=くもほうでん
雲水量=くもみずりょう
曇=くもり
くらげ雲=くらげぐも
黒南風=くろはえ
群速度=ぐんそくど
薫風=くんぷう
傾圧=けいあつ
経緯儀=けいいぎ
警戒水位=けいかいすいい
計画洪水量=けいかくこうずいりょう
計器飛行方式=けいきひこうほうしき
傾向方程式=けいこうほうていしき
計算不安定=けいさんふあんてい
指数=しすう
携帯型通風乾湿計=けいたいがたつうふうかんしつけい
啓蟄=けいちつ
傾度風=けいどふう
軽風=けいふう
警報=けいほう
繋留気球=けいりゅうききゅう
夏至=げし
月光冠=げっこうかん
月柱=げっちゅう
結氷=けっぴょう
結露=けつろ
波=は
巻雲=けんうん
限界温度=げんかいおんど
限界明暗度=げんかいめいあんど
圏界面=けんかいめん
厳寒=げんかん
現在天気=げんざいてんき
原始大気=げんしたいき
幻日=げんじつ
幻日環=げんじつかん
検湿計公式=けんしつけいこうしき
現象日数=げんしょうにっすう
巻積雲=けんせきうん
巻層雲=けんそううん
現地気圧=げんちきあつ
顕熱=けんねつ
顕熱輸送=けんねつゆそう
幻氷=げんぴょう
高圧帯=こうあつたい
豪雨=ごうう
降雨強度計=こううきょうどけい
降雨計=こううけい
降雨日=こううび
降灰=こうかい
降灰=こうはい
光解離=こうかいり
光化学理論=こうかがくりろん
光化学汚染質=こうかがくおせんしつ
光化学=こうかがく
光化学平衡=こうかがくへいこう
光学的厚さ=こうがくてきあつさ
降下煤塵=こうかばいじん
光冠=こうかん
光環=こうかん
交換係数=こうかんけいすう
高気圧=こうきあつ
工業気候学=こうぎょうきこうがく
航空機機上観測通報式=こうくうききじょうかんそくつうほうしき
航空気象=こうくうきしょう
航空気象台=こうくうきしょうだい
航空機の着氷=こうくうきのちゃくひょう
高原霧=こうげんぎり
黄砂=こうさ
高山気候=こうざんきこう
高指数=こうしすう
降水=こうすい
洪水=こうずい
高水位=こうすいい
降水確率予報=こうすいかくりつよほう
洪水警報=こうずいけいほう
洪水注意報=こうずいちゅういほう
降水ばかり=こうすいばかり
降水放射能=こうすいほうしゃのう
洪水予報=こうずいよほう
降水量=こうすいりょう
降水理論=こうすいりろん
合成図=ごうぜいず
合成風=ごうせいふう
高積雲=こうせきうん
降雪=こうせつ
豪雪=ごうせつ
高層雲=こうそううん
高層気象観測=こうそうきしょうかんそく
高層気象台=こうそうきしょうだい
高層大気=こうそうたいき
高層天気図=こうそうてんきず
荒天=こうてん
光電離=こうでんり
黄道光=こうどうこう
黄道光=おうどうこう
後氷期最適気候期=こうひょうきさいてききこうき
降雹制御=こうひょうせいぎょ
紅葉前線=こうようぜんせん
紅葉前線=もみじぜんせん
合流=ごうりゅう
効力=こうりょく
港湾気象官=こうわんきしょうかん
氷=こおり
氷霰=こおりあられ
氷霧=こおりぎり
氷の花=こおりのはな
木枯らし=こがらし
古気候学=こきこうがく
穀雨=こくう
国際雲図帳=こくさいくもずちょう
国際水文学計画=こくさいすいもんがくけいかく
国際地球観測協力年=こくさいちきゅうかんそくきょうりょくねん
国際地球観測年=こくさいちきゅうかんそくねん
国際地点番号=こくさいちてんばんごう
国際防災の10年=こくさいぼうさいのじゅうねん
国際民間航空機関=こくさいみんかんこうくうきかん
酷暑=こくしょ
黒体放射=こくたいほうしゃ
国連環境開発会議=こくれんかんきょうかいはつかいぎ
小雨=こさめ
小潮=こしお
東風=こち
酷寒=こっかん
黒球温度計=こっきゅうおんどけい
粉雪=こなゆき
小ぬか雨=こぬかあめ
木の芽流し=このめながし
小春日和=こはるびより
湖風=こふう
湖面蒸発=こめんじょうはつ
固有値問題=こゆうちもんだい
小雪=こゆき
御来光=ごらいこう
力=ちから
湖陸風=こりくふう
混合距離=こんごうきょり
混合霧=こんごうぎり
混合雲=こんごうぐも
混合層=こんごうそう
混合比=こんごうひ
混合重力波=こんごうじゅうりょくは
混濁因子=こんだくいんし
混濁係数=こんだくけいすう
彩雲=さいうん
災害気候学=さいがいきこうがく
災害対策基本法=さいがいたいさくきほんほう
催花雨=さいかう
最寒月=さいかんげつ
再現期間=さいげんきかん
最高温度計=さいこうおんどけい
最高気温=さいこうきおん
最高最低温度計=さいこうさいていおんどけい
最終昇温=さいしゅうしょうおん
最小観測網=さいしょうかんそくもう
最小偏角=さいしょうへんかく
細塵計=さいじんけい
最深積雪=さいしんせきせつ
最大可能降水量=さいだいかのうこうすいりょう
最大可能洪水量=さいだいかのうこうずいりょう
最大瞬間風速=さいだいしゅんかんふうそく
最大風速=さいだいふうそく
最多風向=さいたふうこう
最暖月=さいだんげつ
最低温度計=さいていおんどけい
最低気温=さいていきおん
最低気象条件=さいていきしょうじょうけん
最適観測網=さいてきかんそくもう
砕波=さいは
細氷=さいひょう
坂上の安定度=さかがみのあんていど
左岸=さがん
昨日来=さくじつらい
作物期間=さくもつきかん
作物気候=さくもつきこう
作物季節=さくもつきせつ
昨夜来=さくやらい
桜前線=さくらぜんせん
砂塵嵐=さじんあらし
五月晴=さつきばれ
五月闇=さつきやみ
雑節=ざっせつ
里雪=さとゆき
砂漠=さばく
砂漠化=さばくか
砂漠気候=さばくきこう
鯖雲=さばぐも
五月雨=さみだれ
作用中心=さようちゅうしん
ざらめ雪=ざらめゆき
山岳気候=さんがくきこう
山岳気象学=さんがくきしょうがく
三角波=さんかくなみ
山岳波=さんがくは
３カ月予報=さんかげつよほう
酸化窒素=さんかちっそ
三寒四温=さんかんしおん
産業気象=さんぎょうきしょう
散光=さんこう
残光=ざんこう
残暑=ざんしょ
酸性雨=さんせいう
酸性霧=さんせいぎり
酸性雪=さんせいせつ
酸素=さんそ
山頂光=さんちょうこう
三杯風速計=さんぱいふうそくけい
散乱=さんらん
地雨=じあめ
気流=きりゅう
効果流=こうかりゅう
塩風=しおかぜ
視界=しかい
紫外域日射計=しがいいきにっしゃけい
紫外線=しがいせん
地鏡=じかがみ
時角=じかく
四季=しき
磁気嵐=じきあらし
自記温湿計=じきおんしつけい
磁気圏=じきけん
磁気圏界面=じきけんかいめん
視距離=しきょり
地霧=じぎり
時雨=じぐれ
北山時雨=きたやましぐれ
時化=しけ
至軽風=しけいふう
資源衛星=しげんえいせい
紫光=しこう
指向=しこう
子午面循環=しごめんじゅんかん
子午面流=しごめんりゅう
指示雨量計=しじうりょうけい
地震波=じしんは
地すべり=じすべり
自然期間=しぜんきかん
自然季節=しぜんきせつ
自然災害=しぜんさいがい
自然放射能=しぜんほうしゃのう
自然暦=しぜんれき
持続性=じぞくせい
湿球=しっきゅう
湿球温度=しっきゅうおんど
疾強風=しっきょうふう
実験気象学=じっけんきしょうがく
実効温度=じっこうおんど
実効湿度=じっこうしつど
湿潤気候=しつじゅんきこう
湿潤空気=しつじゅんくうき
湿潤指数=しつじゅんしすう
湿潤帯=しつじゅんたい
湿潤断熱変化=しつじゅんだんねつへんか
湿数=しっすう
湿舌=しつぜつ
湿度=しつど
室内気候=しつないきこう
室内実験=しつないじっけん
疾風=しっぷう
疾病気候学=しっぺいきこうがく
質量分析器=しつりょうぶんせきき
視程=してい
指定気圧面=していきあつめん
視程障害現象=していしょうがいげんしょう
指定船舶=していせんぱく
自動対流気温減率=じどうたいりゅうきおんげんりつ
支配方程式=しはいほうていしき
地吹雪=じふぶき
しまり雪=しまりゆき
湿り雪=しめりゆき
地面温度=じめんおんど
地面現象警報=じめんげんしょうけいほう
地面状態=じめんじょうたい
地面抵抗=じめんていこう
霜=しも
霜穴=しもあな
霜柱=しもばしら
霜華=しもばな
霜道=しもみち
驟雨=しゅうう
週間天気予報=しゅうかんてんきよほう
周期=しゅうき
周期法=しゅうきほう
住居気候=じゅうきょきこう
周極渦=しゅうきょくうず
周極渦=しゅうきょくか
十五夜=じゅうごや
収支法=しゅうしほう
集水面積=しゅうすいめんせき
終雪=しゅうせつ
驟雪=しゅうせつ
終霜=しゅうそう
収束=しゅうそく
収束線=しゅうそくせん
自由大気=じゆうたいき
集中豪雨=しゅうちゅうごうう
集電器=しゅうでんき
終日=しゅうにち
自由波=じゆうは
集風線=しゅうふうせん
秋分=しゅうぶん
終末速度=しゅうまつそくど
重力波=じゅうりょくは
重力風=じゅうりょくふう
重力補正=じゅうりょくほせい
秋霖=しゅうりん
樹梢波=じゅしょうは
受水器=じゅすいき
樹霜=じゅそう
出水=しゅっすい
主虹=しゅにじ
樹氷=じゅひょう
主要気候=しゅようきこう
旬日=じゅんじつ
順圧=じゅんあつ
循環定理=じゅんかんていり
瞬間風速=しゅんかんふうそく
準器=じゅんき
準地衡風近似=じゅんちこうふうきんじ
準二年周期振動=じゅんにねんしゅうきしんどう
春分=しゅんぶん
春霖=しゅんりん
昇華=しょうか
昇華核=しょうかかく
小寒=しょうかん
蒸気霧=じょうきぎり
小気候=しょうきこう
小規模擾乱=しょうきぼじょうらん
上空の前線=じょうくうのぜんせん
衝撃波=しょうげきは
象限視程=しょうげんしてい
条件付不安程度=じょうけんつきふあんていど
蒸散=じょうさん
消散係数=しょうさんけいすう
小暑=しょうしょ
上昇霧=じょうしょうぎり
上昇気流=じょうしょうきりゅう
小雪=しょうせつ
上層雲=じょうそううん
上層気団=じょうそうきだん
上層風=じょうそうふう
状態曲線=じょうたいきょくせん
状態方程式=じょうたいほうていしき
照度=しょうど
蒸発=じょうはつ
小氷期=しょうひょうき
上部摩擦層=じょうぶまさつそう
小満=しょうまん
擾乱=じょうらん
初期値問題=しょきちもんだい
植物期間=しょくぶつきかん
植物気候=しょくぶつきこう
植物季節学=しょくぶつきせつがく
処暑=しょしょ
初日=しょにち
不知火=しらぬい
白南風=しらはえ
白南風=しろはえ
白虹=しろにじ
地割れ=じわれ
蜃気楼=しんきろう
人工気候=じんこうきこう
人工降雨=じんこうこうう
人工発光雲=じんこうはっこううん
人工放射能=じんこうほうしゃのう
人工雪=じんこうゆき
真珠雲=しんじゅぐも
新積雪=しんせきせつ
新雪雪崩=しんせつなだれ
塵旋風=じんせんぷう
診断型方程式=しんだんがたほうていしき
浸透=しんとう
振動=しんどう
振動回転帯=しんどうかいてんたい
進入限界高度=しんにゅうげんかいこうど
陣風線=じんぷうせん
森林気候=しんりんきこう
森林限界=しんりんげんかい
水位計=すいいけい
水害=すいがい
水害気象業務=すいがいきしょうぎょうむ
水銀温度計=すいぎんおんどけい
水銀気圧計=すいぎんきあつけい
水空=すいくう
水圏=すいけん
水象=すいしょう
水蒸気=すいじょうき
垂直混合=すいちょくこんごう
垂直自然体=すいちょくしぜんたい
垂直視程=すいちょくしてい
垂直不安定=すいちょくふあんてい
水年=すいねん
水平混合=すいへいこんごう
水平循環=すいへいじゅんかん
水平虹=すいへいにじ
水平発散=すいへいはっさん
水平不安定=すいへいふあんてい
水文気象学=すいもんきしょうがく
水理学=すいりがく
数値実験=すうちじっけん
数値予報=すうちよほう
数理気候=すうりきこう
寿都のだし風=すっつのだしかぜ
静圧=せいあつ
生育期間=せいいくきかん
生育期度日=せいいくきどにち
斉一大気=せいいつたいき
斉一非圧縮大気=せいいつひあっしゅくたいき
静穏=せいおん
生活気候学=せいかつきこうがく
生活季節=せいかつきせつ
西岸気候=せいがんきこう
生気象学=せいきしょうがく
西高東低=せいこうとうてい
静止衛星=せいしえいせい
静水圧の関係=せいすいあつのかんけい
成層圏=せいそうけん
生態気候学=せいたいきこうがく
静的安定度=せいてきあんていど
晴天=せいてん
晴天積雲=せいてんせきうん
晴天乱気流=せいてんらんきりゅう
晴天率=せいてんりつ
生物気候=せいぶつきこう
生物季節=せいぶつきせつ
生物圏=せいぶつけん
清明=せいめい
静力学的調節=せいりきがくてきちょうせつ
世界気候計画=せかいきこうけいかく
世界気象監視=せかいきしょうかんし
世界気象機関=せかいきしょうきかん
積雲=せきうん
赤外画像=せきがいがぞう
赤外線=せきがいせん
積算雨量曲線=せきさんうりょうきょくせん
積算雨量計=せきさんうりょうけい
積算温度=せきさんおんど
積雪=せきせつ
積雪深=せきせつしん
赤道=せきどう
赤道気候=せきどうきこう
赤道波=せきどうは
積乱雲=せきらんうん
雪害=せつがい
雪冠=せっかん
接岸初日=せつがんしょにち
赤気=せっき
節気=せっき
雪渓=せっけい
雪線=せっせん
絶対安定=ぜったいあんてい
絶対渦度=ぜったいうずど
絶対温度=ぜったいおんど
絶対角運動量=ぜったいかくうんどうりょう
絶対湿度=ぜったいしつど
絶対標準気圧計=ぜったいひょうじゅんきあつけい
絶対不安定=ぜったいふあんてい
接地気温=せっちきおん
接地気候=せっちきこう
接地逆転=せっちぎゃくてん
接地層=せっちそう
接地気層=せっちきそう
雪泥流=せつでいりゅう
雪庇=せっぴ
節分=せつぶん
雪片=せっぺん
雪盲=せつもう
切離高気圧=せつりこうきあつ
切離低気圧=せつりていきあつ
雪量=せつりょう
雪量計=せつりょうけい
背の高い高気圧=せのたかいこうきあつ
背の低い高気圧=せのひくいこうきあつ
全圧=ぜんあつ
前駆雷撃=ぜんくらいげき
先行降雨指数=せんこうこううしすう
旋衡風=せんこうふう
潜在不安定=せんざいふあんてい
前震=ぜんしん
浅水方程式=せんすいほうていしき
前線=ぜんせん
前線霧=ぜんせんぎり
全層雪崩=ぜんそうなだれ
船体着氷=せんたいちゃくひょう
選択吸収=せんたくきゅうしゅう
全天日射=ぜんてんにっしゃ
潜熱=せんねつ
潜熱輸送=せんねつゆそう
船舶気象通報=せんぱくきしょうつうほう
旋風=せんぷう
せん風=せんぷう
前面=ぜんめん
層雲=そううん
霜害=そうがい
総観気候学=そうかんきこうがく
総観気象学=そうかんきしょうがく
総観予報=そうかんよほう
草原気候=そうげんきこう
層厚=そうこう
霜降=そうこう
層状雲=そうじょううん
層状の雲=そうじょうのくも
層積雲=そうせきうん
窓霜=そうそう
相対渦度=そうたいうずど
相対温度=そうたいおんど
相対太陽黒点数=そうたいたいようこくてんすう
相対発散=そうたいはっさん
霜点=そうてん
霜点温度=そうてんおんど
霜点湿度計=そうてんしつどけい
相当温位=そうとうおんい
相当温度=そうとうおんど
相当向かい風=そうとうむかいかぜ
層別解析=そうべつかいせき
層流=そうりゅう
層流境界層=そうりゅうきょうかいそう
測雲=そくうん
側撃雷=そくげきらい
測風気球観測=そくふうききゅうかんそく
測風塔=そくふうとう
側面混合=そくめんこんごう
底雪崩=そこなだれ
測距局=そっきょきょく
測高公式=そっこうこうしき
測候所=そっこうじょ
粗度=そど
粗度定数=そどじょうすう
粗氷=そひょう
大=だい
大寒=たいかん
体感温度=たいかんおんど
大気=たいき
大気安定度=たいきあんていど
大気汚染=たいきおせん
大気外日射量=たいきがいにっしゃりょう
大気海洋相互作用=たいきかいようそうごさよう
大気化学=たいきかがく
大気拡散=たいきかくさん
大気球観測=だいききゅうかんそく
大気吸収=たいききゅうしゅう
大気境界層=たいききょうかいそう
大気屈折=たいきくっせつ
大気現象記号=たいきげんしょうきごう
大気光=たいきこう
大気候=だいきこう
大気光象=たいきこうしょう
大気混濁度=たいきこんだくど
大気擾乱=たいきじょうらん
大気塵象=たいきじんしょう
大気振動=たいきしんどう
大気水象=たいきすいしょう
大気大循環論=たいきだいじゅんかんろん
大気潮汐=たいきちょうせき
大気電気=たいきでんき
大気透明=たいきとうめい
大気熱収支=たいきねつしゅうし
大気の成層=たいきのせいそう
大気放射=たいきほうしゃ
大規模運動=だいきぼうんどう
大規模擾乱=だいきぼじょうらん
大強風=だいきょうふう
大気路程=たいきろてい
大暑=たいしょ
帯状運動=たいじょううんどう
帯状循環=たいじょうじゅんかん
対称不安定=たいしょうふあんてい
帯状流=たいじょうりゅう
対数法則=たいすうほうそく
大雪=たいせつ
第二種条件付不安定=だいにしゅじょうけんつきふあんてい
台風=たいふう
台風業務実験=たいふうぎょうむじっけん
台風特別実験=たいふうとくべつじっけん
台風の眼=たいふうのめ
太平洋高気圧=たいへいようこうきあつ
太平洋台風=たいへいようたいふう
太陽=たいよう
太陽極小期国際観測年=たいようきょくしょうきこくさいかんそくねん
太陽黒点=たいようこくてん
太陽定数=たいようていすう
太陽同期軌道=たいようどうききどう
太陽放射=たいようほうしゃ
第四紀気候=だいよんききこう
第四紀氷河時代=だいよんきひょうがじだい
大陸気候=たいりくきこう
大陸度=たいりくど
対流=たいりゅう
対流雲=たいりゅううん
対流圏=たいりゅうけん
自記風圧計=じきふうあつけい
多雨期=たうき
高曇=たかぐもり
高潮=たかしお
高波=たかなみ
滝雲=たきぐも
卓越視程=たくえつしてい
卓越風=たくえつふう
筍梅雨=たけのこづゆ
多重圏界面=たじゅうけんかいめん
立待月=たちまちづき
竜巻=たつまき
縦波=たてなみ
谷風=たにかぜ
谷霧=たにぎり
種まき=たねまき
たば風=たばかぜ
多方大気=たほうたいき
多毛雲=たもううん
暖域=だんいき
団塊状の雲=だんかいじょうのくも
炭化水素=たんかすいそ
暖気=だんき
暖気団=だんきだん
短期予報=たんきよほう
暖候期=だんこうき
短時間予報=たんじかんよほう
暖水舌=だんすいぜつ
探測気球=たんそくききゅう
炭素年代=たんそねんだい
暖冬=だんとう
断熱変化=だんねつへんか
短波=たんぱ
暖波=だんぱ
短波放射=たんぱほうしゃ
暖房気候=だんぼうきこう
断面図=だんめんず
地温不易層=ちおんふえきそう
地球温暖化=ちきゅうおんだんか
地球環境汚染=ちきゅうかんきょうおせん
地球環境問題=ちきゅうかんきょうもんだい
地球大気開発計画=ちきゅうたいきかいはつけいかく
地球流体力学=ちきゅうりゅうたいりきがく
ちぎれ雲=ちぎれぐも
竹秋=ちくしゅう
地形性降雨=ちけいせいこうう
地衡風=ちこうふう
地磁気観測所=ちじきかんそくじょ
地象=ちしょう
地上気象観測=ちじょうきしょうかんそく
地上屈折=ちじょうくっせつ
地上天気図=ちじょうてんきず
地上風=ちじょうふう
地中温度=ちちゅうおんど
地中海気候=ちちゅうかいきこう
地中海前線=ちちゅうかいぜんせん
窒素酸化物=ちっそさんかぶつ
地点雨量=ちてんうりょう
地点円=ちてんえん
地表反射日射=ちひょうはんしゃにっしゃ
地表面温度=ちひょうめんおんど
地方気象台=ちほうきしょうだい
着雪=ちゃくせつ
着氷=ちゃくひょう
着陸予報=ちゃくりくよほう
中緯度気団=ちゅういどきだん
中緯度高圧帯=ちゅういどこうあつたい
中緯度高気圧=ちゅういどこうきあつ
中緯度偏西風=ちゅういどへんせいふう
注意報=ちゅういほう
中央気象台=ちゅうおうきしょうだい
中央標準時=ちゅうおうひょうじゅんじ
中間規模擾乱=ちゅうかんきぼじょうらん
中間圏=ちゅうかんけん
中気候=ちゅうきこう
中規模現象=ちゅうきぼげんしょう
中期予報=ちゅうきよほう
中小規模現象=ちゅうしょうきぼげんしょう
中心気圧=ちゅうしんきあつ
中性大気=ちゅうせいたいき
中層雲=ちゅうそううん
中層大気=ちゅうそうたいき
中立平衡=ちゅうりつへいこう
潮位=ちょうい
超音波式波高計=ちょうおんぱしきはこうけい
超音波風速計=ちょうおんぱふうそくけい
長期予報=ちょうきよほう
超高層大気=ちょうこうそうたいき
潮汐風=ちょうせきふう
超長波=ちょうちょうは
長波=ちょうは
長波放射=ちょうはほうしゃ
長波放射計=ちょうはほうしゃけい
跳躍距離=ちょうやくきょり
直接循環=ちょくせつじゅんかん
直達日射=ちょくたつにっしゃ
塵煙霧=ちりえんむ
沈下=ちんか
沈着=ちんちゃく
通常薄明=つうじょうはくめい
通信中枢=つうしんちゅうすう
通報観測=つうほうかんそく
月虹=つきにじ
対馬海峡=つしまかいきょう
筒雪=つつゆき
津波高=つなみだか
津波の遡上=つなみのそじょう
翼雲=つばさぐも
茅花流し=つばなながし
茅=ちがや
つむじ風=つむじかぜ
冷たい雨=つめたいあめ
露=つゆ
梅雨=つゆ
梅雨=ばいう
梅雨明け=つゆあけ
梅雨入り=つゆいり
梅雨寒=つゆざむ
氷柱=つらら
垂氷=つらら
つるし雲=つるしぐも
つるの北帰行=つるのほっきこう
低温注意報=ていおんちゅういほう
低気圧=ていきあつ
抵抗温度計=ていこうおんどけい
抵抗係数=ていこうけいすう
定高度気球=ていこうどききゅう
定高度面天気図=ていこうどめんてんきず
低周波振動=ていしゅうはしんどう
定常状態=ていじょうじょうたい
定常波=ていじょうは
底層=ていそう
低層=ていそう
停滞前線=ていたいぜんせん
値=ち
値=あたい
定点=ていてん
定立波=ていりつは
泥流=でいりゅう
鉄管地中温度計=てっかんちちゅうおんどけい
鉄道気象=てつどうきしょう
鉄砲水=てっぽうみず
電位傾度=でんいけいど
転移層=てんいそう
天気=てんき
電気湿度計=でんきしつどけい
天気図=てんきず
天気相談所=てんきそうだんじょ
電気抵抗温度計=でんきていこうおんどけい
電気抵抗式放射計=でんきていこうしきほうしゃけい
天気日数=てんきにっすう
電気補償式日射計=でんきほしょうしきにっしゃけい
天泣=てんきゅう
天気予報=てんきよほう
天気俚諺=てんきりげん
天空散乱日射=てんくうさんらんにっしゃ
転向=てんこう
天候=てんこう
電光=でんこう
転向帯=てんこうたい
転向点=てんこうてん
電子温度=でんしおんど
電子管式露点計=でんしかんしきろてんけい
天頂弧=てんちょうこ
転倒ます型自記雨量計=てんとうますがたじきうりょうけい
転倒雷=てんとうらい
天明の飢饉=てんめいのききん
天文潮=てんもんちょう
天文薄明=てんもんはくめい
電離圏=でんりけん
電力気象=でんりょくきしょう
動圧=どうあつ
等圧線=とうあつせん
等圧線解析=とうあつせんかいせき
等圧面=とうあつめん
等圧面天気図=とうあつめんてんきず
凍雨=とうう
等温位線=とうおんいせん
等温線=とうおんせん
等温大気=とうおんたいき
凍害=とうがい
透過関数=とうかかんすう
透過係数=とうかけいすう
透過率=とうかりつ
東岸気候=とうがんきこう
動気候学=どうきこうがく
統計的予報=とうけいてきよほう
凍結高度=とうけつこうど
等降水量線=とうこうすいりょうせん
東高西低型=とうこうせいていがた
等高線=とうこうせん
等高線図=とうこうせんず
等混合比線=とうこんごうひせん
冬至=とうじ
同時線=どうじせん
等時線法=とうじせんほう
凍上=とうじょう
搭状雲=とうじょううん
等水張線=とうすいちょうせん
等層厚線=とうそうこうせん
凍土=とうど
等日照線=とうにっしょうせん
等発現線=とうはつげんせん
等比容線=とうひようせん
等比容面=とうひようめん
等比率線=とうひりつせん
等風向線=とうふうこうせん
動物季節学=どうぶつきせつがく
等方性放射=とうほうせいほうしゃ
等密度線=とうみつどせん
同鳴線=どうめいせん
透明度=とうめいど
等流束層=とうりゅうそくそう
凍露=とうろ
十日夜=とおかんや
通り雨=とおりあめ
どか灰=どかばい
どか雪=どかゆき
特異日=とくいび
土佐沖低気圧=とさおきていきあつ
都市気候=としきこう
都市霧=としぎり
都市水害=としすいがい
土壌水分=どじょうすいぶん
土石流=どせきりゅう
突然昇温=とつぜんしょうおん
突風=とっぷう
土用=どよう
土用波=どようなみ
豊旗雲=とよはたぐも
虎が雨=とらがあめ
曇天=どんてん
内聴域=ないちょういき
内部重力波=ないぶじゅうりょくは
内部波=ないぶは
内陸気候=ないりくきこう
内陸霧=ないりくぎり
長雨=ながあめ
流れ雲=ながれぐも
凪=なぎ
菜種梅雨=なたねづゆ
雪崩=なだれ
雪崩風=なだれかぜ
雪崩注意報=なだれちゅういほう
雪崩道=なだれみち
夏の雲=なつのくも
夏日=なつび
蒸気雲=じょうきぐも
斜め視程=ななめしてい
波=なみ
並雲=なみぐも
南下=なんか
南岸低気圧型=なんがんていきあつがた
南極観測=なんきょくかんそく
南高北低型=なんこうほくていがた
南西諸島=なんせいしょとう
軟風=なんぷう
南方振動=なんぽうしんどう
南北交換=なんぼくこうかん
南北指数=なんぼくしすう
逃げ水=にげみず
二酸化炭素=にさんかたんそ
二酸化窒素=にさんかちっそ
虹=にじ
二次汚染物質=にじおせんぶっしつ
二次循環=にじじゅんかん
二次前線=にじぜんせん
二次大気=にじたいき
二至二分=にしにぶん
二重雲=にじゅううん
二重管温度計=にじゅうかんおんどけい
二重圏界面=にじゅうけんかいめん
二十四節気=にじゅうしせっき
26ヶ月周期振動=にじゅうろっかげつしゅうきうんどう
鰊曇り=にしんぐもり
日較差=にちかくさ
日較差=にちこうさ
日降水量=にちこうすいりょう
日最高気温=にちさいこうきおん
日最小相対湿度=にちさいしょうそうたいしつど
日最大1時間降水量=にちさいだいいちじかんこうすいりょう
日最大10分間降水量=にちさいだいじゅっぷんかんこうすいりょう
日最大瞬間風速=にちさいだいしゅんかんふうそく
日最大風速=にちさいだいふうそく
日最低気温=にちさいていきおん
日平均気温=にちへいきんきおん
日平均風速=にちへいきんふうそく
日変化=にちへんか
日光冠=にっこうかん
日射=にっしゃ
日照=にっしょう
二百十日=にひゃくとおか
日本海低気圧型=にほんかいていきあつがた
日本気候表=にほんきこうひょう
日本気象学会=にほんきしょうがっかい
日本気象協会=にほんきしょうきょうかい
日本晴れ=にほんばれ
入道雲=にゅうどうぐも
入梅=にゅうばい
乳房雲=にゅうぼううん
俄雨=にわかあめ
俄雪=にわかゆき
糠雨=ぬかあめ
数=すう
濡れ雪=ぬれゆき
熱汚染=ねつおせん
熱界雷=ねつかいらい
熱圏=ねつけん
熱源=ねつげん
熱圏界面=ねつけんかいめん
熱赤道=ねつせきどう
熱線風速計=ねつせんふうそくけい
熱帯気候=ねったいきこう
熱帯気団=ねったいきだん
熱帯降雨観測衛星=ねったいこううかんそくえいせい
熱帯収束帯=ねったいしゅうそくたい
熱帯擾乱=ねったいじょうらん
熱帯低気圧=ねったいていきあつ
熱帯夜=ねったいや
熱的低気圧=ねつてきていきあつ
熱的不安定=ねつてきふあんてい
熱的数=ねつてきすう
熱電素子=ねつでんそし
熱電対温度計=ねつでんついおんどけい
熱電対列日射計=ねつでんついれつにっしゃけい
熱雷=ねつらい
熱流板計=ねつりゅうばんけい
根雪=ねゆき
年候=ねんこう
年較差=ねんこうさ
年較差=ねんかくさ
学術用語集=ねんかくさ
燃焼核=ねんしょうかく
年々変動=ねんねんへんどう
年平均気温=ねんへいきんきおん
年末低気圧=ねんまつていきあつ
年輪気候学=ねんりんきこうがく
農業気象=のうぎょうきしょう
農事季節=のうじきせつ
濃霧=のうむ
濃密雲=のうみつうん
濃霧注意報=のうむちゅういほう
昇り雲=のぼりぐも
野分=のわき
灰色放射=はいいろほうしゃ
黴雨=ばいう
梅雨前線=ばいうぜんせん
媒塵=ばいじん
南風=はえ
麦秋=ばくしゅう
爆弾低気圧=ばくだんていきあつ
爆発雲=ばくはつぐも
爆発波=ばくはつは
瀑布雲=ばくふぐも
薄明=はくめい
薄明弧=はくめいこ
白夜=はくや
白夜=びゃくや
白露=はくろ
波高=はこう
波状雲=はじょううん
走り梅雨=はしりづゆ
波数=はすう
旗雲=はたぐも
八十八夜=はちじゅうはちや
蜂の巣状雲=はちのすじょううん
初冠雪=はつかんせつ
白金抵抗温度計=はっきんていこうおんどけい
八朔=はっさく
発散=はっさん
発散風=はっさんふう
発散方程式=はっさんほうていしき
初霜=はつしも
初霜日=はつしもび
初雪=はつゆき
波動性低気圧=はどうせいていきあつ
波動方程式=はどうほうていしき
花あらし=はなあらし
花曇り=はなぐもり
花散らし=はなちらし
花冷え=はなびえ
花=はな
羽根雲=はねぐも
早霜=はやじも
早手=はやて
弧=こ
春嵐=はるあらし
春一番=はるいちばん
春一=はるいち
春雨=はるさめ
春二番=はるにばん
春疾風=はるはやて
晴=はれ
晴れ霧=はれぎり
波浪=はろう
半永久低気圧=はんえいきゅうていきあつ
半乾燥気候=はんかんそうきこう
半乾燥地帯=はんかんそうちたい
半夏生=はんげしょう
反射虹=はんしゃにじ
半旬=はんじゅん
万聖節の夏=ばんせいせつのなつ
晩霜=ばんそう
反対幻日=はんたいげんじつ
反対幻日弧=はんたいげんじつこ
反対薄明=はんたいはくめい
反対貿易風=はんたいぼうえきふう
汎天気=はんてんき
汎天候=はんてんこう
反転効果=はんてんこうか
坂東太郎=ばんどうたろう
半透明雲=はんとうめいうん
日脚の伸び=ひあしののび
日暈=ひがさ
日傘効果=ひがさこうか
東海低気圧=ひがししなかいていきあつ
光=ひかり
光温度計=ひかりおんどけい
彼岸=ひがん
微気圧=びきあつ
微気候=びきこう
微気象学=びきしょうがく
非均質圏=ひきんしつけん
低い地吹雪=ひくいじふぶき
低い風塵=ひくいふうじん
飛行機観測=ひこうきかんそく
飛行機雲=ひこうきぐも
氷雨=ひさめ
肱川あらし=ひじかわあらし
比湿=ひしつ
非線形摩擦=ひせんけいまさつ
非断熱変化=ひだんねつへんか
非地衡風=ひちこうふう
羊雲=ひつじぐも
必要換気量=ひつようかんきりょう
旱=ひでり
日照り雨=ひでりあめ
比熱=ひねつ
非発散風=ひはっさんふう
非発散面=ひはっさんめん
微風=びふう
微風計=びふうけい
皮膚温度=ひふおんど
飛沫=ひまつ
百葉箱=ひゃくようばこ
百葉箱=ひゃくようそう
比容=ひよう
雹=ひょう
氷映=ひょうえい
氷河=ひょうが
雹害=ひょうがい
氷河学=ひょうががく
氷河時代=ひょうがじだい
氷河風=ひょうがふう
氷期=ひょうき
氷球温度=ひょうきゅうおんど
氷山=ひょうざん
標準温度=ひょうじゅんおんど
標準気圧=ひょうじゅんきあつ
標準気圧計=ひょうじゅんきあつけい
標準重力=ひょうじゅんじゅうりょく
標準大気=ひょうじゅんたいき
氷床=ひょうしょう
氷晶=ひょうしょう
表層雪崩=ひょうそうなだれ
病虫害=びょうちゅうがい
氷点=ひょうてん
氷点下=ひょうてんか
氷盤=ひょうばん
表面波=ひょうめんは
表面摩擦=ひょうめんまさつ
日和=ひより
避雷=ひらい
熱線気圧計=ねっせんきあつけい
尾流雲=びりゅううん
広島市江波山気象館=ひろしましえばやまきしょうかん
広戸風=ひろとかぜ
不安定=ふあんてい
不安程度=ふあんていど
不安定線=ふあんていせん
型拡散=がたかくさん
風圧=ふうあつ
風化=ふうか
風害=ふうがい
風穴=ふうけつ
風向=ふうこう
風向計=ふうこうけい
風向風速計=ふうこうふうそくけい
風食=ふうしょく
風塵=ふうじん
風水害=ふうすいがい
風雪注意報=ふうせつちゅういほう
風速=ふうそく
風速計=ふうそくけい
風程=ふうてい
風洞=ふうどう
風波=ふうは
風配図=ふうはいず
風力=ふうりょく
風力発電=ふうりょくはつでん
風浪=ふうろう
現象=げんしょう
不快指数=ふかいしすう
吹き出し=ふきだし
吹き溜り=ふきだまり
吹き溜り雪=ふきだまりゆき
吹流し=ふきながし
副低気圧=ふくていきあつ
復度=ふくど
復氷=ふくひょう
更待月=ふけまちづき
房状雲=ふさじょううん
臥待月=ふしまちづき
浮上=ふじょう
不照日数=ふしょうにっすう
藤原の効果=ふじわらのこうか
不測の改変=ふそくのかいへん
舞台風=ぶたいかぜ
二つ玉低気圧=ふたつだまていきあつ
付着温度計=ふちゃくおんどけい
普通気候観測=ふつうきこうかんそく
沸点=ふってん
物理気候学=ぶつりきこうがく
物理気象学=ぶつりきしょうがく
負の粘性=ふのねんせい
吹雪=ふぶき
不偏気団=ふへんきだん
冬=ふゆ
浮遊塵埃=ふゆうじんあい
浮遊塵放射能=ふゆうじんほうしゃのう
浮遊煤塵=ふゆうばいじん
冬の雲=ふゆのくも
冬疾風=ふゆはやて
冬日=ふゆび
浮力=ふりょく
管=かん
不連続線=ふれんぞくせん
分圧=ぶんあつ
分圧温位=ぶんあつおんい
噴火雲=ふんかぐも
分散波=ぶんさんは
平均海面=へいきんかいめん
平均前日差=へいきんぜんじつさ
平均日最高気温=へいきんにちさいこうきおん
平均日最低気温=へいきんにちさいていきおん
平均風向=へいきんふうこう
平均風向風速計=へいきんふうこうふうそくけい
平均風速=へいきんふうそく
併合=へいごう
平常水位=へいじょうすいい
閉そく=へいそく
閉塞前線=へいそくぜんせん
平年値=へいねんち
平年偏差=へいねんへんさ
べき法則=べきほうそく
項=こう
面近似=めんきんじ
べた雪=べたゆき
自記雪量計=じきせつりょうけい
変圧風=へんあつふう
偏形樹=へんけいじゅ
変形場=へんけいば
偏光器=へんこうき
偏差=へんさ
偏西風=へんせいふう
偏東風=へんとうふう
貿易風=ぼうえきふう
貿易風積雲=ぼうえきふうせきうん
飽差=ほうさ
放射=ほうしゃ
放射温度計=ほうしゃおんどけい
放射霧=ほうしゃぎり
放射性物質=ほうしゃせいぶっしつ
放射能式雪量計=ほうしゃのうしきせつりょうけい
放射冷却=ほうしゃれいきゃく
芒種=ぼうしゅ
房総不連続線=ぼうそうふれんぞくせん
暴風=ぼうふう
暴風域=ぼうふういき
暴風雨=ぼうふうう
防風垣=ぼうふうがき
暴風雪=ぼうふうせつ
暴風日数=ぼうふうにっすう
暴風標識=ぼうふうひょうしき
防風林=ぼうふうりん
防霧林=ぼうむりん
飽和=ほうわ
飽和空気=ほうわくうき
飽和水蒸気=ほうわすいじょうき
飽和断熱変化=ほうわだんねつへんか
北高型=ほくこうがた
北東気流型=ほくとうきりゅうがた
北陸不連続線=ほくりくふれんぞくせん
星の瞬き=ほしのまたたき
牡丹雪=ぼたんゆき
北高型=ほっこうがた
穂波=ほなみ
本震=ほんしん
盆地霧=ぼんちぎり
埋積=まいせき
巻き垂れ=まきだれ
幕電=まくでん
枕崎台風=まくらざきたいふう
摩擦層=まさつそう
摩擦速度=まさつそくど
待宵=まつよい
窓霜=まどしも
窓領域=まどりょういき
真夏日=まなつび
真冬日=まふゆび
豆台風=まめたいふう
万年雪=まんねんゆき
水雲=みずぐも
水霜=みずしも
水収支=みずしゅうし
霙=みぞれ
密度補正=みつどほせい
南大東島=みなみだいとうじま
南鳥島=みなみとりしま
脈動=みゃくどう
民間天気会社=みんかんてんきがいしゃ
向い風=むかいかぜ
無人気象観測機=むじんきしょうかんそくき
霧雪=むせつ
無線高層風観測=むせんこうそうふうかんそく
無線方向探知機=むせんほうこうたんちき
無線気象計=むせんきしょうけい
無霜害地帯=むそうがいちたい
霧氷=むひょう
無風帯=むふうたい
無毛雲=むもううん
むら雲=むらくも
村雨=むらさめ
村時雨=むらしぐれ
霧量計=むりょうけい
霧水量計=きりみずりょうけい
室戸台風=むろとたいふう
名月=めいげつ
迷走台風=めいそうたいふう
明度=めいど
目の壁雲=めのかべぐも
面積雨量=めんせきうりょう
面=めん
毛管水=もうかんすい
毛髪湿度計=もうはつしつどけい
模型実験=もけいじっけん
持ち上げ凝結高度=もちあげぎょうけつこうど
戻り梅雨=もどりつゆ
靄=もや
夜光=やこう
夜光雲=やこううん
柳井=やない
丸山波=まるやまは
夜半過ぎ=やはんすぎ
山霧=やまぎり
山崩れ=やまくずれ
山背=やませ
山沿い=やまぞい
山谷風=やまたにかぜ
山の気象=やまのきしょう
山旗雲=やまはたぐも
山本の放射図=やまもとのほうしゃず
山雪=やまゆき
融解=ゆうかい
融解層=ゆうかいそう
有義波高=ゆうぎはこう
有効煙突高=ゆうこうえんとつこう
有効温度=ゆうこうおんど
有効降水量=ゆうこうこうすいりょう
有効太陽放射=ゆうこうたいようほうしゃ
有効地球放射=ゆうこうちきゅうほうしゃ
有効土壌水分=ゆうこうどじょうすいぶん
有効放射計=ゆうこうほうしゃけい
有視界気象状態=ゆうしかいきしょうじょうたい
有視界飛行方式=ゆうしかいひこうほうしき
湧昇=ゆうしょう
遊水池=ゆうすいち
融雪=ゆうせつ
融雪害=ゆうせつがい
融雪洪水=ゆうせつこうずい
夕立=ゆうだち
融点=ゆうてん
誘電率=ゆうでんりつ
夕凪=ゆうなぎ
融氷=ゆうひょう
雄風=ゆうふう
夕焼け=ゆうやけ
雪=ゆき
雪霰=ゆきあられ
雪起こし=ゆきおこし
雪板=ゆきいた
雪形=ゆきがた
雪時雨=ゆきしぐれ
雪の結晶=ゆきのけっしょう
雪迎え=ゆきむかえ
遊糸=ゆうし
夜明け=よあけ
宵のうち=よいのうち
溶岩円頂丘=ようがんえんちょうきゅう
溶岩噴泉=ようがんふんせん
陽子圏=ようしけん
揚子江気団=ようすこうきだん
余寒=よかん
横風=よこかぜ
横波=よこなみ
四次元解析=よじげんかいせき
余震=よしん
予想天気図=よそうてんきず
予測可能性=よそくかのうせい
予報円=よほうえん
予報官=よほうかん
予報区=よほうく
予報精度評価=よほうせいどひょうか
予報中枢=よほうちゅうすう
予報適中率=よほうてきちゅうりつ
予報型方程式=よほうがたほうていしき
雷雨=らいう
雷雲=らいうん
雷雲=かみなりぐも
雷放電=らいほうでん
雷鳴=らいめい
落下球=らっかきゅう
乱気流=らんきりゅう
乱圏=らんけん
乱流圏=らんりゅうけん
乱流=らんりゅう
離岸距離=りがんきょり
力学解析=りきがくかいせき
陸風=りくかぜ
陸霧=りくぎり
理想気体=りそうきたい
立夏=りっか
立秋=りっしゅう
立春=りっしゅん
立冬=りっとう
粒子放射=りゅうしほうしゃ
流出=りゅうしゅつ
流星=りゅうせい
流線=りゅうせん
流束=りゅうそく
流体力学的不安定=りゅうたいりきがくてきふあんてい
流氷=りゅうひょう
流氷終日=りゅうひょうしゅうじつ
流氷初日=りゅうひょうしょにち
流量=りゅうりょう
量的予報=りょうてきよほう
緑閃光=りょくせんこう
離陸予報=りりくよほう
理論気象学=りろんきしょうがく
臨界高度=りんかいこうど
臨界波長=りんかいはちょう
青空比色目盛り=あおぞらひしょくめもり
類似天気図=るいじてんきず
類似法=るいじほう
累年統計=るいねんとうけい
累年平均値=るいねんへいきんち
冷夏=れいか
冷害=れいがい
冷源=れいげん
冷水の湧昇=れいすいのゆうしょう
冷房病=れいぼうびょう
列氏温度目盛=れっしおんどめもり
烈風=れっぷう
浪害=ろうがい
老婦人の夏=ろうふじんのなつ
露場=ろじょう
濾塵計=ろじんけい
露点温度=ろてんおんど
露点計=ろてんけい
自記日射計=じきにっしゃけい
露量=ろりょう
惑星大気=わくせいたいき
忘れ霜=わすれじも
私雨=わたくしあめ
綿雪=わたゆき
和風=わふう
